NUMERO,CODCAJA,VENDEDOR,CODUSU,FECHA,HORA,DESTIC,HASTIC,DESFAC,HASFAC,EFECTIVO,TARJETA,EFECBANCO,TTIC,TFAC,TTICPEN,DESMOV,HASMOV,TENTRADA,TSALIDA,ANSALDO,SALDO,BASEIMP1,IVA1,IMPIVA1,BASEIMP2,IVA2,IMPIVA2,BASEIMP3,IVA3,IMPIVA3,BASEIMP4,IVA4,IMPIVA4,COMENSALES,IMRECUENTO,CONTABILIZ,year_file
1,001,1,2,2023-01-15,16:07:18,29155,29208,0,0,373.7,364.92,0,738.62,0,0,0,0,0,0,133015.6,133383.42,61.85,21.0,12.97,603.44,10.0,60.36,0,4.0,0,0,0.0,0,0,0,False,2023
2,001,1,2,2023-01-16,16:19:08,29209,29231,0,0,83.3,281.2,0,364.5,0,0,0,0,0,0,133389.3,133472.6,18.18,21.0,3.82,311.36,10.0,31.14,0,4.0,0,0,0.0,0,0,0,False,2023
3,001,1,2,2023-01-17,16:21:20,29232,29241,0,0,0,106.2,0,106.2,0,0,0,0,0,0,133472.6,133472.6,2.48,21.0,0.52,93.8,10.0,9.4,0,4.0,0,0,0.0,0,0,0,False,2023
4,001,1,2,2023-01-18,17:14:07,29242,29249,0,0,7.8,72.2,0,80,0,0,0,0,0,0,133472.6,133480.4,9.09,21.0,1.91,62.72,10.0,6.28,0,4.0,0,0,0.0,0,0,0,False,2023
5,001,1,2,2023-01-19,18:09:25,29250,29288,0,0,325.1,78.5,0,403.6,0,0,0,0,0,0,133480.4,133805.5,33.89,21.0,7.11,329.65,10.0,32.95,0,4.0,0,0,0.0,0,0,0,False,2023
6,001,1,2,2023-01-20,17:26:39,29289,29320,0,0,258.4,84.2,0,342.6,0,0,0,0,0,0,133805.5,134063.9,28.51,21.0,5.99,280.09,10.0,28.01,0,4.0,0,0,0.0,0,0,0,False,2023
7,001,1,2,2023-01-21,18:24:38,29321,29365,0,0,393.7,257.6,0,651.3,0,0,0,0,0,0,134063.9,134457.6,74.38,21.0,15.62,510.26,10.0,51.04,0,4.0,0,0,0.0,0,0,0,False,2023
8,001,1,2,2023-01-22,17:44:19,29366,29417,0,0,407.2,354.4,0,761.6,0,0,0,0,0,0,134457.6,134864.8,73.56,21.0,15.44,611.45,10.0,61.15,0,4.0,0,0,0.0,0,0,0,False,2023
9,001,1,2,2023-01-23,16:22:44,29418,29427,0,0,37.2,116.8,0,154,0,0,0,0,0,0,134864.8,134902,31.82,21.0,6.68,104.99,10.0,10.51,0,4.0,0,0,0.0,0,0,0,False,2023
10,001,1,2,2023-01-24,17:36:40,29428,29439,0,0,54.4,122.9,0,177.3,0,0,0,0,0,0,134902,134956.4,14.05,21.0,2.95,145.73,10.0,14.57,0,4.0,0,0,0.0,0,0,0,False,2023
11,001,1,2,2023-01-25,17:19:18,29440,29451,0,0,31,133.5,0,164.5,0,0,0,0,0,0,134956.4,134987.4,10.33,21.0,2.17,138.18,10.0,13.82,0,4.0,0,0,0.0,0,0,0,False,2023
12,001,1,2,2023-01-26,17:03:36,29452,29492,0,0,253.5,63.1,0,316.6,0,0,0,0,0,0,134987.4,135240.9,26.04,21.0,5.46,259.19,10.0,25.91,0,4.0,0,0,0.0,0,0,0,False,2023
13,001,1,2,2023-01-27,18:00:22,29493,29532,0,0,203.6,193.2,0,396.8,0,0,0,0,0,0,135240.9,135444.5,56.22,21.0,11.78,298.9,10.0,29.9,0,4.0,0,0,0.0,0,0,0,False,2023
14,001,1,2,2023-01-28,20:16:42,29533,29586,0,0,395.24,314.4,0,709.64,0,0,0,0,0,0,135444.5,135839.74,93.2,21.0,19.55,542.64,10.0,54.26,0,4.0,0,0,0.0,0,0,0,False,2023
15,001,1,2,2023-01-29,17:52:57,29587,29656,0,0,554.3,433,0,987.3,0,0,0,0,0,0,135839.74,136394.04,50.83,21.0,10.67,841.65,10.0,84.15,0,4.0,0,0,0.0,0,0,0,False,2023
16,001,1,2,2023-01-30,17:16:16,29657,29662,0,0,3.9,56.6,0,60.5,0,0,0,0,0,0,136394.04,136397.94,2.48,21.0,0.52,52.28,10.0,5.22,0,4.0,0,0,0.0,0,0,0,False,2023
17,001,1,2,2023-01-31,15:55:04,29663,29673,0,0,7.8,108.6,0,116.4,0,0,0,0,0,0,136397.94,136405.74,15.29,21.0,3.21,88.99,10.0,8.91,0,4.0,0,0,0.0,0,0,0,False,2023
18,001,1,2,2023-02-01,17:09:03,29674,29679,0,0,9.1,59.6,0,68.7,0,0,0,0,0,0,136405.74,136414.84,6.2,21.0,1.3,55.64,10.0,5.56,0,4.0,0,0,0.0,0,0,0,False,2023
19,001,1,2,2023-02-02,16:27:36,29680,29709,0,0,185.1,86.4,0,271.5,0,0,0,0,0,0,136414.84,136599.94,2.48,21.0,0.52,244.1,10.0,24.4,0,4.0,0,0,0.0,0,0,0,False,2023
20,001,1,2,2023-02-03,16:44:13,29710,29719,0,0,43.1,58.5,0,101.6,0,0,0,0,0,0,136599.94,136643.04,9.09,21.0,1.91,82.37,10.0,8.23,0,4.0,0,0,0.0,0,0,0,False,2023
21,001,1,2,2023-02-04,18:28:32,29720,29775,0,0,486,217.8,0,703.8,0,0,0,0,0,0,136643.04,137129.04,83.89,21.0,17.61,547.54,10.0,54.76,0,4.0,0,0,0.0,0,0,0,False,2023
22,001,1,2,2023-02-05,18:01:48,29776,29827,0,0,543.2,242.5,0,785.7,0,0,0,0,0,0,137129.04,137672.24,109.52,21.0,22.98,593.78,10.0,59.42,0,4.0,0,0,0.0,0,0,0,False,2023
23,001,1,2,2023-02-06,16:58:47,29828,29837,0,0,0,178.1,0,178.1,0,0,0,0,0,0,137672.24,137672.24,4.96,21.0,1.04,156.45,10.0,15.65,0,4.0,0,0,0.0,0,0,0,False,2023
24,001,1,2,2023-02-07,17:15:38,29838,29850,0,0,11.8,150.9,0,162.7,0,0,0,0,0,0,137672.24,137684.04,3.72,21.0,0.78,143.8,10.0,14.4,0,4.0,0,0,0.0,0,0,0,False,2023
25,001,1,2,2023-02-08,16:28:35,29851,29886,0,0,224.8,231.3,0,456.1,0,0,0,0,0,0,137684.04,137908.84,34.71,21.0,7.29,376.43,10.0,37.67,0,4.0,0,0,0.0,0,0,0,False,2023
26,001,1,2,2023-02-09,16:55:49,29887,29914,0,0,190.34,149.9,0,340.24,0,0,0,0,0,0,137908.84,138099.18,14.67,21.0,3.07,293.17,10.0,29.33,0,4.0,0,0,0.0,0,0,0,False,2023
27,001,1,2,2023-02-10,18:22:07,29915,29946,0,0,321.3,51.8,0,373.1,0,0,0,0,0,0,138099.18,138420.48,13.23,21.0,2.77,324.64,10.0,32.46,0,4.0,0,0,0.0,0,0,0,False,2023
28,001,1,2,2023-02-11,19:11:54,29947,29995,0,0,391.2,251.9,0,643.1,0,0,0,0,0,0,138420.48,138811.68,113.66,21.0,23.84,459.61,10.0,45.99,0,4.0,0,0,0.0,0,0,0,False,2023
29,001,1,2,2023-02-12,17:00:28,29996,30048,0,0,605.6,321.8,0,927.4,0,0,0,0,0,0,138811.68,139417.28,82.26,21.0,17.24,752.64,10.0,75.26,0,4.0,0,0,0.0,0,0,0,False,2023
30,001,1,2,2023-02-13,16:59:13,30049,30072,0,0,95.3,205.8,0,301.1,0,0,0,0,0,0,139417.28,139512.58,23.56,21.0,4.94,247.82,10.0,24.78,0,4.0,0,0,0.0,0,0,0,False,2023
31,001,1,2,2023-02-14,17:29:47,30073,30107,0,0,326.2,133.7,0,459.9,0,0,0,0,0,0,139512.58,139838.78,38.03,21.0,7.97,376.24,10.0,37.66,0,4.0,0,0,0.0,0,0,0,False,2023
32,001,1,2,2023-02-15,17:40:12,30108,30119,0,0,0,210.1,0,210.1,0,0,0,0,0,0,139838.78,139838.78,8.68,21.0,1.82,181.45,10.0,18.15,0,4.0,0,0,0.0,0,0,0,False,2023
33,001,1,2,2023-02-16,17:50:30,30120,30135,0,0,45.5,143.1,0,188.6,0,0,0,0,0,0,139838.78,139884.28,16.12,21.0,3.38,153.74,10.0,15.36,0,4.0,0,0,0.0,0,0,0,False,2023
34,001,1,2,2023-02-17,21:13:22,30136,30190,0,0,370.72,134.3,0,505.02,0,0,0,0,0,0,139884.28,140255,63.34,21.0,13.28,389.5,10.0,38.9,0,4.0,0,0,0.0,0,0,0,False,2023
35,001,1,2,2023-02-18,19:02:42,30191,30258,0,0,487.1,281.9,0,769,0,0,0,0,0,0,140255,140742.1,93.4,21.0,19.6,596.4,10.0,59.6,0,4.0,0,0,0.0,0,0,0,False,2023
36,001,1,2,2023-02-19,18:16:54,30259,30304,0,0,320.1,310.3,0,630.4,0,0,0,0,0,0,140742.1,141062.2,82.25,21.0,17.25,482.61,10.0,48.29,0,4.0,0,0,0.0,0,0,0,False,2023
37,001,1,2,2023-02-20,16:05:27,30305,30312,0,0,20.1,68.1,0,88.2,0,0,0,0,0,0,141062.2,141082.3,3.72,21.0,0.78,76.08,10.0,7.62,0,4.0,0,0,0.0,0,0,0,False,2023
38,001,1,2,2023-02-21,16:08:35,30313,30325,0,0,27.9,160.7,0,188.6,0,0,0,0,0,0,141082.3,141110.2,6.2,21.0,1.3,164.64,10.0,16.46,0,4.0,0,0,0.0,0,0,0,False,2023
39,001,1,2,2023-02-22,16:12:22,30326,30348,0,0,98.9,66.9,0,165.8,0,0,0,0,0,0,141110.2,141209.1,3.72,21.0,0.78,146.66,10.0,14.64,0,4.0,0,0,0.0,0,0,0,False,2023
40,001,1,2,2023-02-23,17:15:44,30349,30362,0,0,66.5,132.6,0,199.1,0,0,0,0,0,0,141209.1,141275.6,28.52,21.0,5.98,149.65,10.0,14.95,0,4.0,0,0,0.0,0,0,0,False,2023
41,001,1,2,2023-02-24,18:14:30,30363,30389,1,1,283.06,196.6,0,308.7,170.96,0,0,0,0,0,141275.6,141558.66,6.2,21.0,1.3,429.24,10.0,42.92,0,4.0,0,0,0.0,0,0,0,False,2023
42,001,1,2,2023-02-26,17:55:20,30390,30497,0,0,1009.9,604.5,0,1614.4,0,0,0,0,0,0,141558.66,142568.56,195.89,21.0,41.11,1252.09,10.0,125.31,0,4.0,0,0,0.0,0,0,0,False,2023
43,001,1,2,2023-02-27,16:50:56,30498,30507,0,0,103.4,62.8,0,166.2,0,0,0,0,0,0,142568.56,142671.96,18.6,21.0,3.9,130.64,10.0,13.06,0,4.0,0,0,0.0,0,0,0,False,2023
44,001,1,2,2023-02-28,17:13:57,30508,30515,0,0,4.7,107.6,0,112.3,0,0,0,0,0,0,142671.96,142676.66,14.88,21.0,3.12,85.72,10.0,8.58,0,4.0,0,0,0.0,0,0,0,False,2023
45,001,1,2,2023-03-01,16:39:21,30516,30529,0,0,76.4,151.2,0,227.6,0,0,0,0,0,0,142676.66,142753.06,9.09,21.0,1.91,196.9,10.0,19.7,0,4.0,0,0,0.0,0,0,0,False,2023
46,001,1,2,2023-03-02,19:08:21,30530,30567,0,0,267.12,128,0,395.12,0,0,0,0,0,0,142753.06,143020.18,48.45,21.0,10.17,305.94,10.0,30.56,0,4.0,0,0,0.0,0,0,0,False,2023
47,001,1,2,2023-03-03,17:39:49,30568,30580,0,0,121.9,150.9,0,272.8,0,0,0,0,0,0,143020.18,143142.08,24.79,21.0,5.21,220.72,10.0,22.08,0,4.0,0,0,0.0,0,0,0,False,2023
48,001,1,2,2023-03-04,19:42:50,30581,30640,0,0,491.92,320.4,0,812.32,0,0,0,0,0,0,143142.08,143634,81.93,21.0,17.19,648.34,10.0,64.86,0,4.0,0,0,0.0,0,0,0,False,2023
49,001,1,2,2023-03-05,18:27:17,30641,30688,0,0,425.7,405.6,0,831.3,0,0,0,0,0,0,143634,144059.7,120.67,21.0,25.33,623,10.0,62.3,0,4.0,0,0,0.0,0,0,0,False,2023
50,001,1,2,2023-03-06,16:18:20,30689,30697,0,0,19.2,88.4,0,107.6,0,0,0,0,0,0,144059.7,144078.9,18.18,21.0,3.82,77.81,10.0,7.79,0,4.0,0,0,0.0,0,0,0,False,2023
51,001,1,2,2023-03-07,19:18:17,30698,30737,0,0,283.2,238.7,0,521.9,0,0,0,0,0,0,144078.9,144362.1,58.27,21.0,12.23,410.39,10.0,41.01,0,4.0,0,0,0.0,0,0,0,False,2023
52,001,1,2,2023-03-08,17:52:46,30738,30758,0,0,78.1,207.3,0,285.4,0,0,0,0,0,0,144362.1,144440.2,32.65,21.0,6.85,223.53,10.0,22.37,0,4.0,0,0,0.0,0,0,0,False,2023
53,001,1,2,2023-03-09,16:16:46,30759,30771,0,0,46.9,142.4,0,189.3,0,0,0,0,0,0,144440.2,144487.1,1.24,21.0,0.26,170.74,10.0,17.06,0,4.0,0,0,0.0,0,0,0,False,2023
54,001,1,2,2023-03-10,19:36:22,30772,30820,0,0,348.1,152.2,0,500.3,0,0,0,0,0,0,144487.1,144835.2,36.39,21.0,7.61,414.82,10.0,41.48,0,4.0,0,0,0.0,0,0,0,False,2023
55,001,1,2,2023-03-11,19:51:07,30821,30862,0,0,451.34,120.8,0,572.14,0,0,0,0,0,0,144835.2,145286.54,77.07,21.0,16.17,435.35,10.0,43.55,0,4.0,0,0,0.0,0,0,0,False,2023
56,001,1,2,2023-03-12,19:41:33,30863,30916,0,0,620.9,352.1,0,973,0,0,0,0,0,0,145286.54,145907.44,140.51,21.0,29.49,730.03,10.0,72.97,0,4.0,0,0,0.0,0,0,0,False,2023
57,001,1,2,2023-03-13,16:48:00,30917,30928,0,0,46.9,207.3,0,254.2,0,0,0,0,0,0,145907.44,145954.34,20.25,21.0,4.25,208.82,10.0,20.88,0,4.0,0,0,0.0,0,0,0,False,2023
58,001,1,2,2023-03-14,17:04:31,30929,30936,0,0,17.02,51.7,0,68.72,0,0,0,0,0,0,145954.34,145971.36,2.58,21.0,0.54,59.63,10.0,5.97,0,4.0,0,0,0.0,0,0,0,False,2023
59,001,1,2,2023-03-15,19:27:02,30937,30942,0,0,12.5,66.7,0,79.2,0,0,0,0,0,0,145971.36,145983.86,3.72,21.0,0.78,67.91,10.0,6.79,0,4.0,0,0,0.0,0,0,0,False,2023
60,001,1,2,2023-03-16,18:36:46,30943,30975,0,0,206.7,212.4,0,419.1,0,0,0,0,0,0,145983.86,146190.56,24.38,21.0,5.12,354.16,10.0,35.44,0,4.0,0,0,0.0,0,0,0,False,2023
61,001,1,2,2023-03-17,19:04:49,30976,31000,0,0,132.4,138,0,270.4,0,0,0,0,0,0,146190.56,146322.96,45.05,21.0,9.45,196.26,10.0,19.64,0,4.0,0,0,0.0,0,0,0,False,2023
62,001,1,2,2023-03-18,17:47:06,31001,31042,0,0,333,253.8,0,586.8,0,0,0,0,0,0,146322.96,146655.96,94.23,21.0,19.77,429.83,10.0,42.97,0,4.0,0,0,0.0,0,0,0,False,2023
63,001,1,2,2023-03-19,20:08:00,31043,31096,0,0,719.42,404.7,0,1124.12,0,0,0,0,0,0,146655.96,147375.38,123.26,21.0,25.86,886.39,10.0,88.61,0,4.0,0,0,0.0,0,0,0,False,2023
64,001,1,2,2023-03-20,18:11:35,31097,31107,0,0,58.8,59.3,0,118.1,0,0,0,0,0,0,147375.38,147434.18,0,21.0,0,107.35,10.0,10.75,0,4.0,0,0,0.0,0,0,0,False,2023
65,001,1,2,2023-03-21,15:47:35,31108,31115,0,0,7,113.7,0,120.7,0,0,0,0,0,0,147434.18,147441.18,1.65,21.0,0.35,107.9,10.0,10.8,0,4.0,0,0,0.0,0,0,0,False,2023
66,001,1,2,2023-03-22,16:16:16,31116,31124,0,0,0,114.2,0,114.2,0,0,0,0,0,0,147441.18,147441.18,7.02,21.0,1.48,96.09,10.0,9.61,0,4.0,0,0,0.0,0,0,0,False,2023
67,001,1,2,2023-03-23,18:03:30,31125,31127,0,0,16.3,39,0,55.3,0,0,0,0,0,0,147441.18,147457.48,2.48,21.0,0.52,47.54,10.0,4.76,0,4.0,0,0,0.0,0,0,0,False,2023
68,001,1,2,2023-03-24,19:52:12,31128,31155,0,0,272.3,84.9,0,357.2,0,0,0,0,0,0,147457.48,147729.78,25.64,21.0,5.36,296.52,10.0,29.68,0,4.0,0,0,0.0,0,0,0,False,2023
69,001,1,2,2023-03-25,17:45:09,31156,31196,0,0,408.4,265,0,673.4,0,0,0,0,0,0,147729.78,148138.18,64.89,21.0,13.61,540.79,10.0,54.11,0,4.0,0,0,0.0,0,0,0,False,2023
70,001,1,2,2023-03-26,18:54:01,31197,31244,0,0,503.12,453.2,0,956.32,0,0,0,0,0,0,148138.18,148641.3,62.92,21.0,13.2,800.22,10.0,79.98,0,4.0,0,0,0.0,0,0,0,False,2023
71,001,1,2,2023-03-27,16:52:43,31245,31252,0,0,12.2,61,0,73.2,0,0,0,0,0,0,148641.3,148653.5,4.55,21.0,0.95,61.55,10.0,6.15,0,4.0,0,0,0.0,0,0,0,False,2023
72,001,1,2,2023-03-28,15:48:13,31253,31257,0,0,0,74.9,0,74.9,0,0,0,0,0,0,148653.5,148653.5,3.31,21.0,0.69,64.46,10.0,6.44,0,4.0,0,0,0.0,0,0,0,False,2023
73,001,1,2,2023-03-30,16:06:05,31258,31270,0,0,44.9,87.2,0,132.1,0,0,0,0,0,0,148653.5,148698.4,55.05,21.0,11.55,59.55,10.0,5.95,0,4.0,0,0,0.0,0,0,0,False,2023
74,001,1,2,2023-03-31,20:50:29,31271,31287,0,0,147.2,167.1,0,314.3,0,0,0,0,0,0,148698.4,148845.6,151.34,21.0,31.76,119.26,10.0,11.94,0,4.0,0,0,0.0,0,0,0,False,2023
75,001,1,2,2023-04-01,21:56:34,31288,31342,0,0,372.9,524.3,0,897.2,0,0,0,0,0,0,148845.6,149218.5,540.59,21.0,113.52,220.99,10.0,22.11,0,4.0,0,0,0.0,0,0,0,False,2023
76,001,1,2,2023-04-02,16:04:09,31343,31377,0,0,353.1,216.8,0,569.9,0,0,0,0,0,0,149218.5,149571.6,387.26,21.0,81.35,92.09,10.0,9.21,0,4.0,0,0,0.0,0,0,0,False,2023
77,001,1,2,2023-04-03,16:35:55,31378,31387,0,0,61.9,78.3,0,140.2,0,0,0,0,0,0,149571.6,149633.5,70.99,21.0,14.91,49.36,10.0,4.94,0,4.0,0,0,0.0,0,0,0,False,2023
78,001,1,2,2023-04-04,16:57:36,31388,31404,0,0,126.7,125.6,0,252.3,0,0,0,0,0,0,149633.5,149760.2,146.94,21.0,30.87,67.74,10.0,6.76,0,4.0,0,0,0.0,0,0,0,False,2023
79,001,1,2,2023-04-05,20:38:38,31405,31446,0,0,301.42,202.5,0,503.92,0,0,0,0,0,0,149760.2,150061.62,319.92,21.0,67.2,106.17,10.0,10.63,0,4.0,0,0,0.0,0,0,0,False,2023
80,001,1,2,2023-04-06,18:50:49,31447,31462,0,0,146.4,162.7,0,309.1,0,0,0,0,0,0,150061.62,150208.02,142.48,21.0,29.92,124.27,10.0,12.43,0,4.0,0,0,0.0,0,0,0,False,2023
81,001,1,2,2023-04-07,19:47:23,31463,31516,0,0,360.92,374.2,0,735.12,0,0,0,0,0,0,150208.02,150568.94,470.79,21.0,98.86,150.46,10.0,15.04,0,4.0,0,0,0.0,0,0,0,False,2023
82,001,1,2,2023-04-08,17:51:59,31517,31549,0,0,318.4,104.6,0,423,0,0,0,0,0,0,150568.94,150887.34,259.85,21.0,54.55,98.7,10.0,9.9,0,4.0,0,0,0.0,0,0,0,False,2023
83,001,1,2,2023-04-09,19:40:24,31550,31605,0,0,568.24,421.4,0,989.64,0,0,0,0,0,0,150887.34,151455.58,552.59,21.0,116.08,291.79,10.0,29.21,0,4.0,0,0,0.0,0,0,0,False,2023
84,001,1,2,2023-04-10,18:15:46,31606,31646,0,0,109.14,149.12,0,258.26,0,0,0,0,0,0,151455.58,151564.72,95.03,21.0,19.93,130.26,10.0,13.04,0,4.0,0,0,0.0,0,0,0,False,2023
85,001,1,2,2023-04-11,21:56:30,31647,31721,0,0,745.4,291.3,0,1036.7,0,0,0,0,0,0,151564.72,152310.12,693.31,21.0,145.59,179.8,10.0,18,0,4.0,0,0,0.0,0,0,0,False,2023
86,001,1,2,2023-04-13,15:26:03,31722,31727,0,0,10.5,50.4,0,60.9,0,0,0,0,0,0,152310.12,152320.62,30.59,21.0,6.41,21.72,10.0,2.18,0,4.0,0,0,0.0,0,0,0,False,2023
87,001,1,2,2023-04-14,21:01:53,31728,31749,0,0,129.24,139.6,0,268.84,0,0,0,0,0,0,152320.62,152449.86,103.43,21.0,21.72,130.63,10.0,13.07,0,4.0,0,0,0.0,0,0,0,False,2023
88,001,1,2,2023-04-15,17:49:36,31750,31786,0,0,247,282.9,0,529.9,0,0,0,0,0,0,152449.86,152696.86,343.24,21.0,72.06,104.17,10.0,10.43,0,4.0,0,0,0.0,0,0,0,False,2023
89,001,1,2,2023-04-16,18:12:22,31787,31832,0,0,520.42,291.3,0,811.72,0,0,0,0,0,0,152696.86,153217.28,548.88,21.0,115.25,134.17,10.0,13.43,0,4.0,0,0,0.0,0,0,0,False,2023
90,001,1,2,2023-04-17,16:09:36,31833,31863,0,0,271.02,195.2,0,466.22,0,0,0,0,0,0,153217.28,153488.3,249.01,21.0,52.32,149.91,10.0,14.99,0,4.0,0,0,0.0,0,0,0,False,2023
91,001,1,2,2023-04-18,18:12:33,31864,31871,0,0,55.3,42.5,0,97.8,0,0,0,0,0,0,153488.3,153543.6,60.1,21.0,12.6,22.82,10.0,2.28,0,4.0,0,0,0.0,0,0,0,False,2023
92,001,1,2,2023-04-20,19:52:52,31872,31884,0,0,58.4,158.5,0,216.9,0,0,0,0,0,0,153543.6,153602,99.69,21.0,20.91,87.55,10.0,8.75,0,4.0,0,0,0.0,0,0,0,False,2023
93,001,1,2,2023-04-21,21:41:01,31885,31908,0,0,169.4,167,0,336.4,0,0,0,0,0,0,153602,153771.4,174.29,21.0,36.61,114.09,10.0,11.41,0,4.0,0,0,0.0,0,0,0,False,2023
94,001,1,2,2023-04-24,16:18:30,31909,32002,0,0,821.32,700.1,0,1521.42,0,0,0,0,0,0,153771.4,154592.72,962.01,21.0,202.02,324.88,10.0,32.52,0,4.0,0,0,0.0,0,0,0,False,2023
95,001,1,2,2023-04-24,16:24:02,32003,32004,0,0,3.6,3,0,6.6,0,0,0,0,0,0,154592.72,154596.32,2.48,21.0,0.52,3.27,10.0,0.33,0,4.0,0,0,0.0,0,0,0,False,2023
96,001,1,2,2023-04-25,15:09:18,32005,32013,0,0,50.7,94.2,0,144.9,0,0,0,0,0,0,154596.32,154647.02,68.34,21.0,14.37,56.54,10.0,5.66,0,4.0,0,0,0.0,0,0,0,False,2023
97,001,1,2,2023-04-27,18:25:37,32014,32038,0,0,208.3,77.2,0,285.5,0,0,0,0,0,0,154647.02,154855.32,190.66,21.0,40.05,49.8,10.0,5,0,4.0,0,0,0.0,0,0,0,False,2023
98,001,1,2,2023-04-28,19:43:57,32039,32064,0,0,194.72,149.6,0,344.32,0,0,0,0,0,0,154855.32,155050.04,200.95,21.0,42.19,91.97,10.0,9.23,0,4.0,0,0,0.0,0,0,0,False,2023
99,001,1,2,2023-04-29,20:24:44,32065,32102,0,0,218.26,246.2,0,464.46,0,0,0,0,0,0,155050.04,155268.3,302.06,21.0,63.4,89.97,10.0,9.03,0,4.0,0,0,0.0,0,0,0,False,2023
100,001,1,2,2023-04-30,17:57:18,32103,32144,0,0,602,191.9,0,793.9,0,0,0,0,0,0,155268.3,155870.3,458.92,21.0,96.38,216.91,10.0,21.69,0,4.0,0,0,0.0,0,0,0,False,2023
101,001,1,2,2023-05-01,18:44:02,32145,32191,0,0,549.7,231.7,0,781.4,0,0,0,0,0,0,155870.3,156420,493.24,21.0,103.58,167.8,10.0,16.8,0,4.0,0,0,0.0,0,0,0,False,2023
102,001,1,2,2023-05-03,18:37:30,32192,32224,0,0,251.4,98.5,0,349.9,0,0,0,0,0,0,156420,156671.4,225.73,21.0,47.38,69.81,10.0,6.99,0,4.0,0,0,0.0,0,0,0,False,2023
103,001,1,2,2023-05-04,16:23:10,32225,32248,0,0,182.6,92.1,0,274.7,0,0,0,0,0,0,156671.4,156854,180.51,21.0,37.89,51.18,10.0,5.12,0,4.0,0,0,0.0,0,0,0,False,2023
104,001,1,2,2023-05-05,20:32:20,32249,32287,0,0,284.2,181.3,0,465.5,0,0,0,0,0,0,156854,157138.2,269.54,21.0,56.66,126.64,10.0,12.66,0,4.0,0,0,0.0,0,0,0,False,2023
105,001,1,2,2023-05-07,20:41:09,32288,32434,0,0,1525.4,727,0,2252.4,0,0,0,0,0,0,157138.2,158663.6,1356.66,21.0,284.85,555.35,10.0,55.55,0,4.0,0,0,0.0,0,0,0,False,2023
106,001,1,2,2023-05-08,16:44:09,32435,32467,0,0,286.7,120,0,406.7,0,0,0,0,0,0,158663.6,158950.3,252.08,21.0,52.92,92.45,10.0,9.25,0,4.0,0,0,0.0,0,0,0,False,2023
107,001,1,2,2023-05-09,17:04:08,32468,32479,2,3,84.2,85.6,0,149.8,20,0,0,0,0,0,158950.3,159034.5,108.44,21.0,22.76,35.09,10.0,3.51,0,4.0,0,0,0.0,0,0,0,False,2023
108,001,1,2,2023-05-11,17:20:08,32480,32505,0,0,192.5,57.4,0,249.9,0,0,0,0,0,0,159034.5,159227,182.24,21.0,38.26,26.73,10.0,2.67,0,4.0,0,0,0.0,0,0,0,False,2023
109,001,1,2,2023-05-13,21:53:32,32506,32598,0,0,1021.22,275.3,0,1296.52,0,0,0,0,0,0,159227,160248.22,835.74,21.0,175.5,259.32,10.0,25.98,0,4.0,0,0,0.0,0,0,0,False,2023
110,001,1,3,2023-05-18,08:52:59,32599,32717,0,0,820.56,646.4,0,1466.96,0,0,0,0,0,0,160248.22,161068.78,841.19,21.0,176.71,408.24,10.0,40.86,0,4.0,0,0,0.0,0,0,0,False,2023
111,001,1,3,2023-05-18,17:23:53,32721,32749,0,0,206.92,112,0,318.92,0,0,0,0,0,0,161068.78,161275.7,204.82,21.0,43,64.62,10.0,6.48,0,4.0,0,0,0.0,0,0,0,False,2023
112,001,1,3,2023-05-19,20:21:47,32750,32796,0,0,291.4,157,0,448.4,0,0,0,0,0,0,161275.7,161567.1,342.65,21.0,71.95,30.73,10.0,3.07,0,4.0,0,0,0.0,0,0,0,False,2023
113,001,1,3,2023-05-20,21:27:20,32797,32845,0,0,504.62,209.7,0,714.32,0,0,0,0,0,0,161567.1,162071.72,447.06,21.0,93.86,157.62,10.0,15.78,0,4.0,0,0,0.0,0,0,0,False,2023
114,001,1,3,2023-05-21,17:38:04,32846,32914,0,0,665,324.2,0,989.2,0,0,0,0,0,0,162071.72,162736.72,619.35,21.0,130.06,217.98,10.0,21.82,0,4.0,0,0,0.0,0,0,0,False,2023
115,001,1,3,2023-05-22,20:43:59,32915,32956,0,0,412.74,188.4,0,601.14,0,0,0,0,0,0,162736.72,163149.46,329.48,21.0,69.18,184.09,10.0,18.41,0,4.0,0,0,0.0,0,0,0,False,2023
116,001,1,3,2023-05-23,17:25:52,32957,32978,0,0,267.2,121.6,0,388.8,0,0,0,0,0,0,163149.46,163416.66,193.05,21.0,40.55,141.11,10.0,14.09,0,4.0,0,0,0.0,0,0,0,False,2023
117,001,1,3,2023-05-25,17:09:25,32979,32998,0,0,148.8,82.4,0,231.2,0,0,0,0,0,0,163416.66,163565.46,152.83,21.0,32.07,42.08,10.0,4.22,0,4.0,0,0,0.0,0,0,0,False,2023
118,001,1,3,2023-05-26,18:18:51,32999,33029,0,0,201,142.4,0,343.4,0,0,0,0,0,0,163565.46,163766.46,196.85,21.0,41.35,95.64,10.0,9.56,0,4.0,0,0,0.0,0,0,0,False,2023
119,001,1,3,2023-05-27,18:34:32,33030,33064,0,0,383.1,165.1,0,548.2,0,0,0,0,0,0,163766.46,164149.56,343.3,21.0,72.11,120.72,10.0,12.08,0,4.0,0,0,0.0,0,0,0,False,2023
120,001,1,3,2023-05-28,17:57:27,33065,33097,0,0,415.82,202.5,0,618.32,0,0,0,0,0,0,164149.56,164565.38,363.13,21.0,76.29,162.64,10.0,16.26,0,4.0,0,0,0.0,0,0,0,False,2023
121,001,1,3,2023-05-29,17:27:03,33098,33125,0,0,228.3,54.9,0,283.2,0,0,0,0,0,0,164565.38,164793.68,150.49,21.0,31.61,91.9,10.0,9.2,0,4.0,0,0,0.0,0,0,0,False,2023
122,001,1,3,2023-05-30,15:44:42,33126,33151,0,0,252.9,64.2,0,317.1,0,0,0,0,0,0,164793.68,165046.58,147.62,21.0,30.98,125.88,10.0,12.62,0,4.0,0,0,0.0,0,0,0,False,2023
123,001,1,3,2023-06-01,19:29:18,33152,33195,0,0,265.6,229.2,0,494.8,0,0,0,0,0,0,165046.58,165312.18,299.69,21.0,62.93,120.17,10.0,12.03,0,4.0,0,0,0.0,0,0,0,False,2023
124,001,1,3,2023-06-02,18:11:06,33196,33223,0,0,194.3,132.8,0,327.1,0,0,0,0,0,0,165312.18,165506.48,173.14,21.0,36.37,106.89,10.0,10.71,0,4.0,0,0,0.0,0,0,0,False,2023
125,001,1,3,2023-06-03,00:26:48,33224,33239,0,0,237.32,114.1,0,351.42,0,0,0,0,0,0,165506.48,165743.8,138.28,21.0,29.05,167.37,10.0,16.73,0,4.0,0,0,0.0,0,0,0,False,2023
126,001,1,3,2023-06-03,19:28:35,33240,33284,0,0,389.14,321.3,0,710.44,0,0,0,0,0,0,165743.8,166132.94,464.86,21.0,97.59,134.53,10.0,13.47,0,4.0,0,0,0.0,0,0,0,False,2023
127,001,1,3,2023-06-04,00:24:59,33285,33304,0,0,236.8,95.4,0,332.2,0,0,0,0,0,0,166132.94,166369.74,229.75,21.0,48.25,49.28,10.0,4.92,0,4.0,0,0,0.0,0,0,0,False,2023
128,001,1,3,2023-06-04,17:10:43,33305,33348,0,0,584.1,243.2,0,827.3,0,0,0,0,0,0,166369.74,166953.84,384.37,21.0,80.73,329.27,10.0,32.93,0,4.0,0,0,0.0,0,0,0,False,2023
129,001,1,3,2023-06-05,16:03:00,33349,33369,0,0,148.8,50.2,0,199,0,0,0,0,0,0,166953.84,167102.64,155.18,21.0,32.62,10.18,10.0,1.02,0,4.0,0,0,0.0,0,0,0,False,2023
130,001,1,3,2023-06-06,00:56:59,33370,33382,0,0,252.4,5,0,257.4,0,0,0,0,0,0,167102.64,167355.04,189.26,21.0,39.74,25.81,10.0,2.59,0,4.0,0,0,0.0,0,0,0,False,2023
131,001,1,3,2023-06-06,17:43:07,33383,33406,0,0,119.2,144.9,0,264.1,0,0,0,0,0,0,167355.04,167474.24,197.3,21.0,41.4,23.08,10.0,2.32,0,4.0,0,0,0.0,0,0,0,False,2023
132,001,1,3,2023-06-06,23:12:30,33407,33416,0,0,90.4,33.3,0,123.7,0,0,0,0,0,0,167474.24,167564.64,61.08,21.0,12.82,45.27,10.0,4.53,0,4.0,0,0,0.0,0,0,0,False,2023
133,001,1,3,2023-06-08,17:26:32,33417,33456,0,0,274.6,201.1,0,475.7,0,0,0,0,0,0,167564.64,167839.24,283.16,21.0,59.45,120.97,10.0,12.13,0,4.0,0,0,0.0,0,0,0,False,2023
134,001,1,3,2023-06-08,23:42:54,33457,33469,0,0,201.5,24.5,0,226,0,0,0,0,0,0,167839.24,168040.74,150.33,21.0,31.57,40.09,10.0,4.01,0,4.0,0,0,0.0,0,0,0,False,2023
135,001,1,3,2023-06-09,17:11:54,33470,33499,0,0,257.1,164.9,0,422,0,0,0,0,0,0,168040.74,168297.84,266.88,21.0,56.02,90.1,10.0,9,0,4.0,0,0,0.0,0,0,0,False,2023
136,001,1,3,2023-06-10,01:43:07,33500,33514,0,0,136.6,189,0,325.6,0,0,0,0,0,0,168297.84,168434.44,249.37,21.0,52.34,21.72,10.0,2.18,0,4.0,0,0,0.0,0,0,0,False,2023
137,001,1,3,2023-06-10,17:38:51,33515,33551,0,0,456.2,224.6,0,680.8,0,0,0,0,0,0,168434.44,168890.64,426.81,21.0,89.6,149.45,10.0,14.95,0,4.0,0,0,0.0,0,0,0,False,2023
138,001,1,3,2023-06-10,23:57:24,33552,33566,0,0,97.3,75.4,0,172.7,0,0,0,0,0,0,168890.64,168987.94,124.97,21.0,26.24,19.54,10.0,1.96,0,4.0,0,0,0.0,0,0,0,False,2023
139,001,1,3,2023-06-11,16:01:50,33567,33597,0,0,267.8,266.2,0,534,0,0,0,0,0,0,168987.94,169255.74,344.3,21.0,72.3,106.71,10.0,10.69,0,4.0,0,0,0.0,0,0,0,False,2023
140,001,1,3,2023-06-12,20:08:23,33598,33638,0,0,386.04,75.5,0,461.54,0,0,0,0,0,0,169255.74,169641.78,258.15,21.0,54.22,135.62,10.0,13.58,0,4.0,0,0,0.0,0,0,0,False,2023
141,001,1,3,2023-06-13,00:03:59,33639,33641,0,0,47.3,0,0,47.3,0,0,0,0,0,0,169641.78,169689.08,36.86,21.0,7.74,2.45,10.0,0.25,0,4.0,0,0,0.0,0,0,0,False,2023
142,001,1,3,2023-06-13,17:29:06,33642,33667,0,0,263.3,51.4,0,314.7,0,0,0,0,0,0,169689.08,169952.38,176.11,21.0,36.99,92.34,10.0,9.26,0,4.0,0,0,0.0,0,0,0,False,2023
143,001,1,3,2023-06-13,23:49:59,33668,33669,0,0,24.3,0,0,24.3,0,0,0,0,0,0,169952.38,169976.68,13.47,21.0,2.83,7.27,10.0,0.73,0,4.0,0,0,0.0,0,0,0,False,2023
144,001,1,3,2023-06-13,23:54:49,33670,33670,0,0,4.5,0,0,4.5,0,0,0,0,0,0,169976.68,169981.18,3.72,21.0,0.78,0,10.0,0,0,4.0,0,0,0.0,0,0,0,False,2023
145,001,1,3,2023-06-15,16:07:18,33671,33701,0,0,277.5,112.1,0,389.6,0,0,0,0,0,0,169981.18,170258.68,220.9,21.0,46.4,111.17,10.0,11.13,0,4.0,0,0,0.0,0,0,0,False,2023
146,001,1,3,2023-06-15,23:49:03,33702,33707,0,0,59.6,33.1,0,92.7,0,0,0,0,0,0,170258.68,170318.28,60.41,21.0,12.69,17.82,10.0,1.78,0,4.0,0,0,0.0,0,0,0,False,2023
147,001,1,3,2023-06-16,17:17:45,33708,33733,0,0,156.02,152.1,0,308.12,0,0,0,0,0,0,170318.28,170474.3,178.52,21.0,37.5,83.71,10.0,8.39,0,4.0,0,0,0.0,0,0,0,False,2023
148,001,1,3,2023-06-17,00:32:02,33734,33743,0,0,47.92,47.7,0,95.62,0,0,0,0,0,0,170474.3,170522.22,63.08,21.0,13.25,17.55,10.0,1.75,0,4.0,0,0,0.0,0,0,0,False,2023
149,001,1,3,2023-06-17,17:50:20,33744,33784,0,0,351,287.3,0,638.3,0,0,0,0,0,0,170522.22,170873.22,374.88,21.0,78.74,167.9,10.0,16.8,0,4.0,0,0,0.0,0,0,0,False,2023
150,001,1,3,2023-06-17,23:55:34,33785,33788,0,0,101.5,14.9,0,116.4,0,0,0,0,0,0,170873.22,170974.72,86.69,21.0,18.21,10.45,10.0,1.05,0,4.0,0,0,0.0,0,0,0,False,2023
151,001,1,3,2023-06-18,17:24:30,33789,33829,0,0,376.1,269.5,0,645.6,0,0,0,0,0,0,170974.72,171350.82,422.64,21.0,88.76,121.96,10.0,12.24,0,4.0,0,0,0.0,0,0,0,False,2023
152,001,1,3,2023-06-19,16:43:52,33830,33865,0,0,252.2,200.6,0,452.8,0,0,0,0,0,0,171350.82,171603.02,248.83,21.0,52.27,137.9,10.0,13.8,0,4.0,0,0,0.0,0,0,0,False,2023
153,001,1,3,2023-06-20,00:02:19,33866,33870,0,0,99.3,0,0,99.3,0,0,0,0,0,0,171603.02,171702.32,82.07,21.0,17.23,0,10.0,0,0,4.0,0,0,0.0,0,0,0,False,2023
154,001,1,3,2023-06-20,16:32:42,33871,33897,0,0,312.7,78.5,0,391.2,0,0,0,0,0,0,171702.32,172015.02,225.44,21.0,47.36,107.63,10.0,10.77,0,4.0,0,0,0.0,0,0,0,False,2023
155,001,1,3,2023-06-22,17:03:12,33898,33918,0,0,101,128.8,0,229.8,0,0,0,0,0,0,172015.02,172116.02,121.08,21.0,25.42,75.73,10.0,7.57,0,4.0,0,0,0.0,0,0,0,False,2023
156,001,1,3,2023-06-22,23:40:19,33919,33923,0,0,35.8,19.2,0,55,0,0,0,0,0,0,172116.02,172151.82,40.51,21.0,8.5,5.45,10.0,0.55,0,4.0,0,0,0.0,0,0,0,False,2023
157,001,1,3,2023-06-23,19:01:15,33924,33953,0,0,219.6,167.1,0,386.7,0,0,0,0,0,0,172151.82,172371.42,260.9,21.0,54.82,64.54,10.0,6.46,0,4.0,0,0,0.0,0,0,0,False,2023
158,001,1,3,2023-06-24,00:42:56,33954,33959,0,0,59.3,0,0,59.3,0,0,0,0,0,0,172371.42,172430.72,26.86,21.0,5.64,24.36,10.0,2.44,0,4.0,0,0,0.0,0,0,0,False,2023
159,001,1,3,2023-06-24,18:05:29,33960,33997,0,0,349.2,319,0,668.2,0,0,0,0,0,0,172430.72,172779.92,408.83,21.0,85.87,157.71,10.0,15.79,0,4.0,0,0,0.0,0,0,0,False,2023
160,001,1,3,2023-06-25,17:09:20,33998,34038,0,0,419.6,369.5,0,789.1,0,0,0,0,0,0,172779.92,173199.52,431.44,21.0,90.67,242.71,10.0,24.29,0,4.0,0,0,0.0,0,0,0,False,2023
161,001,1,3,2023-06-26,00:45:51,34039,34050,0,0,131.7,158.9,0,290.6,0,0,0,0,0,0,173199.52,173331.22,197.79,21.0,41.52,46.64,10.0,4.66,0,4.0,0,0,0.0,0,0,0,False,2023
162,001,1,3,2023-06-26,16:30:17,34051,34079,0,0,298.3,30.9,0,329.2,0,0,0,0,0,0,173331.22,173629.52,169.17,21.0,35.54,113.18,10.0,11.32,0,4.0,0,0,0.0,0,0,0,False,2023
163,001,1,3,2023-06-26,23:25:19,34080,34083,0,0,108.4,0,0,108.4,0,0,0,0,0,0,173629.52,173737.92,89.59,21.0,18.81,0,10.0,0,0,4.0,0,0,0.0,0,0,0,False,2023
164,001,1,3,2023-06-27,15:41:07,34084,34106,0,0,140.04,58.5,0,198.54,0,0,0,0,0,0,173737.92,173877.96,128.88,21.0,27.07,38.73,10.0,3.87,0,4.0,0,0,0.0,0,0,0,False,2023
165,001,1,3,2023-06-29,16:58:32,34107,34135,0,0,182.6,199.9,0,382.5,0,0,0,0,0,0,173877.96,174060.56,259.18,21.0,54.42,62.63,10.0,6.27,0,4.0,0,0,0.0,0,0,0,False,2023
166,001,1,3,2023-06-29,23:55:36,34136,34143,0,0,30.4,8.2,0,38.6,0,0,0,0,0,0,174060.56,174090.96,23.55,21.0,4.97,9.18,10.0,0.92,0,4.0,0,0,0.0,0,0,0,False,2023
167,001,1,3,2023-06-30,16:30:11,34144,34165,0,0,178,63,0,241,0,0,0,0,0,0,174090.96,174268.96,131.75,21.0,27.65,74.17,10.0,7.43,0,4.0,0,0,0.0,0,0,0,False,2023
168,001,1,3,2023-07-01,01:06:43,34166,34182,0,0,271.62,153.4,0,425.02,0,0,0,0,0,0,174268.96,174540.58,309.12,21.0,64.9,46.37,10.0,4.63,0,4.0,0,0,0.0,0,0,0,False,2023
169,001,1,3,2023-07-01,17:45:09,34183,34217,0,0,473.8,56.7,0,530.5,0,0,0,0,0,0,174540.58,175014.38,333.84,21.0,70.07,115.1,10.0,11.5,0,4.0,0,0,0.0,0,0,0,False,2023
170,001,1,3,2023-07-02,00:32:05,34218,34231,0,0,136.6,135.5,0,272.1,0,0,0,0,0,0,175014.38,175150.98,210.58,21.0,44.22,15.71,10.0,1.59,0,4.0,0,0,0.0,0,0,0,False,2023
171,001,1,3,2023-07-02,16:11:38,34232,34285,0,0,585.6,335.2,0,920.8,0,0,0,0,0,0,175150.98,175736.58,523.89,21.0,110.02,260.79,10.0,26.11,0,4.0,0,0,0.0,0,0,0,False,2023
172,001,1,3,2023-07-03,16:06:54,34286,34297,0,0,120.7,19,0,139.7,0,0,0,0,0,0,175736.58,175857.28,79.67,21.0,16.73,39.35,10.0,3.95,0,4.0,0,0,0.0,0,0,0,False,2023
173,001,1,3,2023-07-04,18:03:44,34298,34321,0,0,139.9,118.1,0,258,0,0,0,0,0,0,175857.28,175997.18,170.27,21.0,35.74,47.27,10.0,4.73,0,4.0,0,0,0.0,0,0,0,False,2023
174,001,1,3,2023-07-06,18:27:00,34322,34358,0,0,229.04,114.5,0,343.54,0,0,0,0,0,0,175997.18,176226.22,239.39,21.0,50.25,48.98,10.0,4.92,0,4.0,0,0,0.0,0,0,0,False,2023
175,001,1,3,2023-07-06,23:58:01,34359,34360,0,0,0,51.7,0,51.7,0,0,0,0,0,0,176226.22,176226.22,41.48,21.0,8.72,1.36,10.0,0.14,0,4.0,0,0,0.0,0,0,0,False,2023
176,001,1,3,2023-07-07,17:59:13,34361,34395,0,0,306.8,104.8,0,411.6,0,0,0,0,0,0,176226.22,176533.02,278.09,21.0,58.41,68.25,10.0,6.85,0,4.0,0,0,0.0,0,0,0,False,2023
177,001,1,3,2023-07-08,02:22:22,34396,34400,0,0,6.9,44.7,0,51.6,0,0,0,0,0,0,176533.02,176539.92,31.08,21.0,6.52,12.72,10.0,1.28,0,4.0,0,0,0.0,0,0,0,False,2023
178,001,1,3,2023-07-08,17:24:18,34401,34445,0,0,538.5,302.9,0,841.4,0,0,0,0,0,0,176539.92,177078.42,491.19,21.0,103.11,224.64,10.0,22.46,0,4.0,0,0,0.0,0,0,0,False,2023
179,001,1,3,2023-07-09,01:24:05,34446,34459,0,0,131.5,359.1,0,490.6,0,0,0,0,0,0,177078.42,177209.92,371.56,21.0,78.04,37.27,10.0,3.73,0,4.0,0,0,0.0,0,0,0,False,2023
180,001,1,3,2023-07-09,17:17:18,34460,34512,0,0,536.3,321.9,0,858.2,0,0,0,0,0,0,177209.92,177746.22,520.52,21.0,109.29,207.62,10.0,20.78,0,4.0,0,0,0.0,0,0,0,False,2023
181,001,1,3,2023-07-10,18:57:40,34513,34541,0,0,347,76.9,0,423.9,0,0,0,0,0,0,177746.22,178093.22,183.14,21.0,38.48,183.91,10.0,18.39,0,4.0,0,0,0.0,0,0,0,False,2023
182,001,1,3,2023-07-10,23:57:53,34542,34547,0,0,46.3,48.8,0,95.1,0,0,0,0,0,0,178093.22,178139.52,66.2,21.0,13.9,13.63,10.0,1.37,0,4.0,0,0,0.0,0,0,0,False,2023
183,001,1,3,2023-07-11,17:10:21,34548,34580,0,0,245.7,167.7,0,413.4,0,0,0,0,0,0,178139.52,178385.22,224.62,21.0,47.18,128.7,10.0,12.9,0,4.0,0,0,0.0,0,0,0,False,2023
184,001,1,3,2023-07-13,17:54:33,34581,34601,0,0,133.22,66.1,0,199.32,0,0,0,0,0,0,178385.22,178518.44,125.74,21.0,26.38,42.89,10.0,4.31,0,4.0,0,0,0.0,0,0,0,False,2023
185,001,1,3,2023-07-13,23:52:26,34602,34604,0,0,0,39.2,0,39.2,0,0,0,0,0,0,178518.44,178518.44,14.88,21.0,3.12,19.27,10.0,1.93,0,4.0,0,0,0.0,0,0,0,False,2023
186,001,1,3,2023-07-14,18:15:00,34605,34637,0,0,300.32,81.3,0,381.62,0,0,0,0,0,0,178518.44,178818.76,205.9,21.0,43.24,120.47,10.0,12.03,0,4.0,0,0,0.0,0,0,0,False,2023
187,001,1,3,2023-07-15,01:41:17,34638,34642,0,0,48.9,62.8,0,111.7,0,0,0,0,0,0,178818.76,178867.66,89,21.0,18.7,3.64,10.0,0.36,0,4.0,0,0,0.0,0,0,0,False,2023
188,001,1,3,2023-07-15,17:04:54,34643,34673,0,0,286.5,167.3,0,453.8,0,0,0,0,0,0,178867.66,179154.16,276.19,21.0,58.02,108.71,10.0,10.89,0,4.0,0,0,0.0,0,0,0,False,2023
189,001,1,3,2023-07-16,00:41:01,34674,34682,0,0,141.1,73.2,0,214.3,0,0,0,0,0,0,179154.16,179295.26,142.55,21.0,29.95,38.01,10.0,3.79,0,4.0,0,0,0.0,0,0,0,False,2023
190,001,1,3,2023-07-16,17:46:31,34683,34731,0,0,403.9,396,0,799.9,0,0,0,0,0,0,179295.26,179699.16,497.34,21.0,104.47,180.08,10.0,18.02,0,4.0,0,0,0.0,0,0,0,False,2023
191,001,1,3,2023-07-17,00:16:16,34732,34736,0,0,43.5,37.5,0,81,0,0,0,0,0,0,179699.16,179742.66,54.72,21.0,11.49,13.45,10.0,1.35,0,4.0,0,0,0.0,0,0,0,False,2023
192,001,1,3,2023-07-17,17:57:14,34737,34761,0,0,267.8,49.1,0,316.9,0,0,0,0,0,0,179742.66,180010.46,204.75,21.0,42.95,62.89,10.0,6.31,0,4.0,0,0,0.0,0,0,0,False,2023
193,001,1,3,2023-07-18,16:54:56,34762,34785,0,0,197.6,160.8,0,358.4,0,0,0,0,0,0,180010.46,180208.06,170.31,21.0,35.79,138.44,10.0,13.86,0,4.0,0,0,0.0,0,0,0,False,2023
194,001,1,3,2023-07-20,16:49:24,34786,34805,0,0,106.42,168.3,0,274.72,0,0,0,0,0,0,180208.06,180314.48,171.79,21.0,36.04,60.81,10.0,6.09,0,4.0,0,0,0.0,0,0,0,False,2023
195,001,1,3,2023-07-21,17:37:31,34806,34834,0,0,271.2,91.2,0,362.4,0,0,0,0,0,0,180314.48,180585.68,231.91,21.0,48.69,74.34,10.0,7.46,0,4.0,0,0,0.0,0,0,0,False,2023
196,001,1,3,2023-07-22,00:10:48,34835,34837,0,0,64.2,41.5,0,105.7,0,0,0,0,0,0,180585.68,180649.88,37.77,21.0,7.93,54.55,10.0,5.45,0,4.0,0,0,0.0,0,0,0,False,2023
197,001,1,3,2023-07-22,18:44:24,34838,34880,0,0,435.6,277.9,0,713.5,0,0,0,0,0,0,180649.88,181085.48,456.32,21.0,95.88,146.63,10.0,14.67,0,4.0,0,0,0.0,0,0,0,False,2023
198,001,1,3,2023-07-23,00:12:32,34881,34887,0,0,31.5,91.5,0,123,0,0,0,0,0,0,181085.48,181116.98,93.23,21.0,19.57,9.27,10.0,0.93,0,4.0,0,0,0.0,0,0,0,False,2023
199,001,1,3,2023-07-23,18:31:06,34888,34941,0,0,473.85,305.1,0,778.95,0,0,0,0,0,0,181116.98,181590.83,518.88,21.0,108.98,137.34,10.0,13.76,0,4.0,0,0,0.0,0,0,0,False,2023
200,001,1,3,2023-07-24,16:31:56,34942,34961,0,0,162.4,131,0,293.4,0,0,0,0,0,0,181590.83,181753.23,129.59,21.0,27.21,124.17,10.0,12.43,0,4.0,0,0,0.0,0,0,0,False,2023
201,001,1,3,2023-07-25,19:10:15,34962,34982,0,0,228.12,63.7,0,291.82,0,0,0,0,0,0,181753.23,181981.35,173.48,21.0,36.44,74.45,10.0,7.45,0,4.0,0,0,0.0,0,0,0,False,2023
202,001,1,3,2023-07-27,19:05:22,34983,35008,0,0,205.3,111.6,0,316.9,0,0,0,0,0,0,181981.35,182186.65,184.87,21.0,38.83,84.73,10.0,8.47,0,4.0,0,0,0.0,0,0,0,False,2023
203,001,1,3,2023-07-28,16:47:02,35009,35028,0,0,224.6,5,0,229.6,0,0,0,0,0,0,182186.65,182411.25,136.76,21.0,28.74,58.28,10.0,5.82,0,4.0,0,0,0.0,0,0,0,False,2023
204,001,1,3,2023-07-29,02:41:49,35029,35035,0,0,127.6,74.9,0,202.5,0,0,0,0,0,0,182411.25,182538.85,137.61,21.0,28.89,32.73,10.0,3.27,0,4.0,0,0,0.0,0,0,0,False,2023
205,001,1,3,2023-07-29,17:51:10,35036,35075,0,0,272.5,317.2,0,589.7,0,0,0,0,0,0,182538.85,182811.35,376.61,21.0,79.09,121.81,10.0,12.19,0,4.0,0,0,0.0,0,0,0,False,2023
206,001,1,3,2023-07-30,00:45:52,35076,35079,0,0,50.9,65,0,115.9,0,0,0,0,0,0,182811.35,182862.25,75.13,21.0,15.77,22.73,10.0,2.27,0,4.0,0,0,0.0,0,0,0,False,2023
207,001,1,3,2023-07-30,18:14:48,35080,35131,0,0,455.62,357,0,812.62,0,0,0,0,0,0,182862.25,183317.87,453.33,21.0,95.21,240.08,10.0,24.02,0,4.0,0,0,0.0,0,0,0,False,2023
208,001,1,3,2023-07-31,17:19:46,35132,35163,0,0,259.92,121.3,0,381.22,0,0,0,0,0,0,183317.87,183577.79,213.01,21.0,44.72,112.25,10.0,11.25,0,4.0,0,0,0.0,0,0,0,False,2023
209,001,1,3,2023-07-31,23:49:14,35164,35168,0,0,36.92,17.9,0,54.82,0,0,0,0,0,0,183577.79,183614.71,41.33,21.0,8.69,4.36,10.0,0.44,0,4.0,0,0,0.0,0,0,0,False,2023
210,001,1,3,2023-08-01,17:25:33,35169,35203,0,0,339.64,65.5,0,405.14,0,0,0,0,0,0,183614.71,183954.35,228.64,21.0,48,116.8,10.0,11.7,0,4.0,0,0,0.0,0,0,0,False,2023
211,001,1,3,2023-08-03,21:44:56,35204,35238,0,0,357.42,36.8,0,394.22,0,0,0,0,0,0,183954.35,184311.77,193.42,21.0,40.6,145.63,10.0,14.57,0,4.0,0,0,0.0,0,0,0,False,2023
212,001,1,3,2023-08-04,17:45:37,35239,35270,0,0,320.9,90.8,0,411.7,0,0,0,0,0,0,184311.77,184632.67,249.85,21.0,52.47,99.46,10.0,9.94,0,4.0,0,0,0.0,0,0,0,False,2023
213,001,1,3,2023-08-05,01:40:40,35271,35279,0,0,69,61.4,0,130.4,0,0,0,0,0,0,184632.67,184701.67,79.84,21.0,16.76,30.73,10.0,3.07,0,4.0,0,0,0.0,0,0,0,False,2023
214,001,1,3,2023-08-05,18:00:15,35280,35325,0,0,628,105,0,733,0,0,0,0,0,0,184701.67,185329.67,490.08,21.0,102.92,127.27,10.0,12.73,0,4.0,0,0,0.0,0,0,0,False,2023
215,001,1,3,2023-08-06,17:20:01,35326,35358,0,0,347.4,179.7,0,527.1,0,0,0,0,0,0,185329.67,185677.07,293.54,21.0,61.67,156.24,10.0,15.66,0,4.0,0,0,0.0,0,0,0,False,2023
216,001,1,3,2023-08-07,17:28:26,35359,35399,0,0,322.12,143.1,0,465.22,0,0,0,0,0,0,185677.07,185999.19,243.03,21.0,51.01,155.63,10.0,15.57,0,4.0,0,0,0.0,0,0,0,False,2023
217,001,1,3,2023-08-07,23:56:24,35400,35405,0,0,42,45.5,0,87.5,0,0,0,0,0,0,185999.19,186041.19,26.04,21.0,5.46,50.91,10.0,5.09,0,4.0,0,0,0.0,0,0,0,False,2023
218,001,1,3,2023-08-08,18:35:42,35406,35443,0,0,372.22,116.3,0,488.52,0,0,0,0,0,0,186041.19,186413.41,261.45,21.0,54.87,156.54,10.0,15.66,0,4.0,0,0,0.0,0,0,0,False,2023
219,001,1,3,2023-08-08,23:39:54,35444,35450,0,0,80.8,52,0,132.8,0,0,0,0,0,0,186413.41,186494.21,77.61,21.0,16.29,35.37,10.0,3.53,0,4.0,0,0,0.0,0,0,0,False,2023
220,001,1,3,2023-08-09,16:45:58,35451,35505,0,0,188.1,131.5,0,319.6,0,0,0,0,0,0,186494.21,186682.31,102.67,21.0,21.55,177.61,10.0,17.79,0,4.0,0,0,0.0,0,0,0,False,2023
221,001,1,3,2023-08-09,23:45:10,35506,35507,0,0,80.1,12.7,0,92.8,0,0,0,0,0,0,186682.31,186762.41,75.7,21.0,15.9,1.09,10.0,0.11,0,4.0,0,0,0.0,0,0,0,False,2023
222,001,1,3,2023-08-10,16:18:35,35508,35534,0,0,224.6,66.9,0,291.5,0,0,0,0,0,0,186762.41,186987.01,154.72,21.0,32.48,94.82,10.0,9.48,0,4.0,0,0,0.0,0,0,0,False,2023
223,001,1,3,2023-08-10,23:35:19,35535,35536,0,0,52,43.1,0,95.1,0,0,0,0,0,0,186987.01,187039.01,64.54,21.0,13.56,15.46,10.0,1.54,0,4.0,0,0,0.0,0,0,0,False,2023
224,001,1,3,2023-08-11,18:21:36,35537,35583,0,0,332.5,253.1,0,585.6,0,0,0,0,0,0,187039.01,187371.51,374.47,21.0,78.63,120.41,10.0,12.09,0,4.0,0,0,0.0,0,0,0,False,2023
225,001,1,3,2023-08-11,23:41:42,35584,35586,0,0,66.8,61,0,127.8,0,0,0,0,0,0,187371.51,187438.31,80.82,21.0,16.98,27.27,10.0,2.73,0,4.0,0,0,0.0,0,0,0,False,2023
226,001,1,3,2023-08-13,01:02:38,35587,35635,0,0,419.2,284.5,0,703.7,0,0,0,0,0,0,187438.31,187857.51,428.84,21.0,90.07,167.97,10.0,16.83,0,4.0,0,0,0.0,0,0,0,False,2023
227,001,1,3,2023-08-13,16:00:17,35636,35673,0,0,374.3,197.7,0,572,0,0,0,0,0,0,187857.51,188231.81,342.62,21.0,71.98,143.08,10.0,14.32,0,4.0,0,0,0.0,0,0,0,False,2023
228,001,1,3,2023-08-14,17:05:50,35674,35710,0,0,405.9,39.8,0,445.7,0,0,0,0,0,0,188231.81,188637.71,279.5,21.0,58.7,97.72,10.0,9.78,0,4.0,0,0,0.0,0,0,0,False,2023
229,001,1,3,2023-08-14,23:12:52,35711,35711,0,0,2,0,0,2,0,0,0,0,0,0,188637.71,188639.71,1.65,21.0,0.35,0,10.0,0,0,4.0,0,0,0.0,0,0,0,False,2023
230,001,1,3,2023-08-15,16:40:08,35712,35751,0,0,271.1,237.4,0,508.5,0,0,0,0,0,0,188639.71,188910.81,312.73,21.0,65.67,118.28,10.0,11.82,0,4.0,0,0,0.0,0,0,0,False,2023
231,001,1,3,2023-08-16,14:05:13,35752,35771,0,0,103.8,40.4,0,144.2,0,0,0,0,0,0,188910.81,189014.61,60.34,21.0,12.66,64.7,10.0,6.5,0,4.0,0,0,0.0,0,0,0,False,2023
232,001,1,3,2023-08-21,16:51:40,35772,35799,0,0,226.2,40.1,0,266.3,0,0,0,0,0,0,189014.61,189240.81,127.12,21.0,26.7,102.26,10.0,10.24,0,4.0,0,0,0.0,0,0,0,False,2023
233,001,1,3,2023-08-22,18:58:01,35800,35829,0,0,204.6,139.9,0,344.5,0,0,0,0,0,0,189240.81,189445.41,215.45,21.0,45.25,76.17,10.0,7.63,0,4.0,0,0,0.0,0,0,0,False,2023
234,001,1,3,2023-08-23,18:37:31,35830,35853,0,0,174.8,118,0,292.8,0,0,0,0,0,0,189445.41,189620.21,195.42,21.0,41.08,51.16,10.0,5.14,0,4.0,0,0,0.0,0,0,0,False,2023
235,001,1,3,2023-08-24,15:20:12,35854,35887,0,0,221.3,67.6,0,288.9,0,0,0,0,0,0,189620.21,189841.51,146.12,21.0,30.68,101.86,10.0,10.24,0,4.0,0,0,0.0,0,0,0,False,2023
236,001,1,3,2023-08-25,16:45:32,35888,35931,0,0,356.9,183,0,539.9,0,0,0,0,0,0,189841.51,190198.41,309.1,21.0,64.9,150.82,10.0,15.08,0,4.0,0,0,0.0,0,0,0,False,2023
237,001,1,3,2023-08-26,18:51:40,35932,35970,0,0,414.02,108.6,0,522.62,0,0,0,0,0,0,190198.41,190612.43,295.23,21.0,61.99,150.35,10.0,15.05,0,4.0,0,0,0.0,0,0,0,False,2023
238,001,1,3,2023-08-27,17:57:33,35971,36035,0,0,590.8,496,0,1086.8,0,0,0,0,0,0,190612.43,191203.23,690.69,21.0,145.03,228.23,10.0,22.87,0,4.0,0,0,0.0,0,0,0,False,2023
239,001,1,3,2023-08-28,16:15:04,36036,36057,0,0,153,76.2,0,229.2,0,0,0,0,0,0,191203.23,191356.23,142.49,21.0,29.91,51.63,10.0,5.17,0,4.0,0,0,0.0,0,0,0,False,2023
240,001,1,3,2023-08-29,18:03:05,36058,36087,0,0,184.02,92.1,0,276.12,0,0,0,0,0,0,191356.23,191540.25,164.73,21.0,34.59,69.81,10.0,6.99,0,4.0,0,0,0.0,0,0,0,False,2023
241,001,1,3,2023-08-30,15:50:52,36088,36098,0,0,84.8,90.3,0,175.1,0,0,0,0,0,0,191540.25,191625.05,54.72,21.0,11.48,98.99,10.0,9.91,0,4.0,0,0,0.0,0,0,0,False,2023
242,001,1,3,2023-08-31,21:08:40,36099,36143,0,0,336.92,95.2,0,432.12,0,0,0,0,0,0,191625.05,191961.97,294.71,21.0,61.91,68.63,10.0,6.87,0,4.0,0,0,0.0,0,0,0,False,2023
243,001,1,3,2023-09-01,20:24:43,36144,36185,0,0,438.34,70.9,0,509.24,0,0,0,0,0,0,191961.97,192400.31,286.64,21.0,60.21,147.62,10.0,14.78,0,4.0,0,0,0.0,0,0,0,False,2023
244,001,1,3,2023-09-02,00:38:45,36186,36192,0,0,186.5,27,0,213.5,0,0,0,0,0,0,192400.31,192586.81,117.77,21.0,24.73,64.55,10.0,6.45,0,4.0,0,0,0.0,0,0,0,False,2023
245,001,1,3,2023-09-02,20:07:35,36193,36247,0,0,417.02,373.4,0,790.42,0,0,0,0,0,0,192586.81,193003.83,495.97,21.0,104.15,172.99,10.0,17.31,0,4.0,0,0,0.0,0,0,0,False,2023
246,001,1,3,2023-09-03,00:39:22,36248,36253,0,0,128.52,24,0,152.52,0,0,0,0,0,0,193003.83,193132.35,113.66,21.0,23.86,13.64,10.0,1.36,0,4.0,0,0,0.0,0,0,0,False,2023
247,001,1,3,2023-09-03,19:41:43,36254,36310,0,0,407.7,463.6,0,871.3,0,0,0,0,0,0,193132.35,193540.05,599.51,21.0,125.89,132.61,10.0,13.29,0,4.0,0,0,0.0,0,0,0,False,2023
