NUMERO,CODCAJA,VENDEDOR,CODUSU,FECHA,HORA,DESTIC,HASTIC,DESFAC,HASFAC,EFECTIVO,TARJETA,EFECBANCO,TTIC,TFAC,TTICPEN,DESMOV,HASMOV,TENTRADA,TSALIDA,ANSALDO,SALDO,BASEIMP1,IVA1,IMPIVA1,BASEIMP2,IVA2,IMPIVA2,BASEIMP3,IVA3,IMPIVA3,BASEIMP4,IVA4,IMPIVA4,COMENSALES,IMRECUENTO,CONTABILIZ,year_file
1,001,1,2,2022-01-04,17:09:45,17919,17930,0,0,10.2,76.7,0,86.9,0,0,0,0,0,0,76113.73,76123.93,1.24,21.0,0.26,77.64,10.0,7.76,0,4.0,0,0,0.0,0,0,0,False,2022
2,001,1,2,2022-01-05,18:02:33,17931,17947,0,0,23.4,33.4,0,56.8,0,0,0,0,0,0,76123.93,76147.33,0,21.0,0,51.67,10.0,5.13,0,4.0,0,0,0.0,0,0,0,False,2022
3,001,1,2,2022-01-06,17:03:49,17948,17958,0,0,19,56,0,75,0,0,0,0,0,0,76147.33,76166.33,0,21.0,0,68.19,10.0,6.81,0,4.0,0,0,0.0,0,0,0,False,2022
4,001,1,2,2022-01-07,16:16:57,17959,17978,0,0,40,50,0,90,0,0,0,0,0,0,76166.33,76206.33,0,21.0,0,81.84,10.0,8.16,0,4.0,0,0,0.0,0,0,0,False,2022
5,001,1,2,2022-01-08,18:58:52,17979,18012,0,0,79.3,37.2,0,116.5,0,0,0,0,0,0,76206.33,76285.63,0,21.0,0,105.96,10.0,10.54,0,4.0,0,0,0.0,0,0,0,False,2022
6,001,1,2,2022-01-09,16:48:07,18013,18087,0,0,545.6,36.6,0,582.2,0,0,0,0,0,0,76285.63,76831.23,20.83,21.0,4.37,506.42,10.0,50.58,0,4.0,0,0,0.0,0,0,0,False,2022
7,001,1,2,2022-01-09,17:15:00,18088,18088,0,0,5,0,0,5,0,0,0,0,0,0,76831.23,76836.23,0,21.0,0,4.55,10.0,0.45,0,4.0,0,0,0.0,0,0,0,False,2022
8,001,1,2,2022-01-10,17:18:29,18089,18120,0,0,71.2,17.5,0,88.7,0,0,0,0,0,0,76836.23,76907.43,0,21.0,0,80.62,10.0,8.08,0,4.0,0,0,0.0,0,0,0,False,2022
9,001,1,2,2022-01-11,21:27:41,18121,18163,0,0,65,98.1,0,163.1,0,0,0,0,0,0,76907.43,76972.43,0,21.0,0,148.28,10.0,14.82,0,4.0,0,0,0.0,0,0,0,False,2022
10,001,1,2,2022-01-12,16:55:05,18164,18201,0,0,52.2,62.2,0,114.4,0,0,0,0,0,0,76972.43,77024.63,0,21.0,0,104,10.0,10.4,0,4.0,0,0,0.0,0,0,0,False,2022
11,001,1,2,2022-01-13,16:49:27,18202,18231,0,0,44.9,20.2,0,65.1,0,0,0,0,0,0,77024.63,77069.53,0,21.0,0,59.16,10.0,5.94,0,4.0,0,0,0.0,0,0,0,False,2022
12,001,1,2,2022-01-14,16:35:47,18232,18267,0,0,52.2,35.5,0,87.7,0,0,0,0,0,0,77069.53,77121.73,0,21.0,0,79.72,10.0,7.98,0,4.0,0,0,0.0,0,0,0,False,2022
13,001,1,2,2022-01-15,18:26:33,18268,18319,0,0,339.8,81.5,0,421.3,0,0,0,0,0,0,77121.73,77461.53,0,21.0,0,382.98,10.0,38.32,0,4.0,0,0,0.0,0,0,0,False,2022
14,001,1,2,2022-01-16,16:29:17,18320,18376,0,0,471.7,69.7,0,541.4,0,0,0,0,0,0,77461.53,77933.23,1.24,21.0,0.26,490.78,10.0,49.12,0,4.0,0,0,0.0,0,0,0,False,2022
15,001,1,2,2022-01-17,15:16:47,18377,18410,0,0,60.9,33.4,0,94.3,0,0,0,0,0,0,77933.23,77994.13,0,21.0,0,85.74,10.0,8.56,0,4.0,0,0,0.0,0,0,0,False,2022
16,001,1,2,2022-01-19,17:12:45,18411,18434,0,0,41.6,24.9,0,66.5,0,0,0,0,0,0,77994.13,78035.73,0,21.0,0,60.45,10.0,6.05,0,4.0,0,0,0.0,0,0,0,False,2022
17,001,1,2,2022-01-20,15:42:39,18435,18463,0,0,37.4,0,0,37.4,0,0,0,0,0,0,78035.73,78073.13,0,21.0,0,34,10.0,3.4,0,4.0,0,0,0.0,0,0,0,False,2022
18,001,1,2,2022-01-21,17:06:55,18464,18495,0,0,45.4,85,0,130.4,0,0,0,0,0,0,78073.13,78118.53,0,21.0,0,118.54,10.0,11.86,0,4.0,0,0,0.0,0,0,0,False,2022
19,001,1,2,2022-01-22,17:58:05,18496,18550,0,0,231.6,42,0,273.6,0,0,0,0,0,0,78118.53,78350.13,0,21.0,0,248.76,10.0,24.84,0,4.0,0,0,0.0,0,0,0,False,2022
20,001,1,2,2022-01-23,14:48:56,18551,18590,0,0,271.8,59.4,0,331.2,0,0,0,0,0,0,78350.13,78621.93,0,21.0,0,301.08,10.0,30.12,0,4.0,0,0,0.0,0,0,0,False,2022
21,001,1,2,2022-01-24,16:51:01,18591,18620,0,0,62,0,0,62,0,0,0,0,0,0,78621.93,78683.93,0,21.0,0,56.38,10.0,5.62,0,4.0,0,0,0.0,0,0,0,False,2022
22,001,1,2,2022-01-25,15:13:22,18621,18643,0,0,39.5,0,0,39.5,0,0,0,0,0,0,78683.93,78723.43,0,21.0,0,35.94,10.0,3.56,0,4.0,0,0,0.0,0,0,0,False,2022
23,001,1,2,2022-01-26,16:10:19,18644,18676,0,0,49,0,0,49,0,0,0,0,0,0,78723.43,78772.43,0,21.0,0,44.53,10.0,4.47,0,4.0,0,0,0.0,0,0,0,False,2022
24,001,1,2,2022-01-27,16:24:08,18677,18712,0,0,56.7,0,0,56.7,0,0,0,0,0,0,78772.43,78829.13,0,21.0,0,51.53,10.0,5.17,0,4.0,0,0,0.0,0,0,0,False,2022
25,001,1,2,2022-01-28,17:50:35,18713,18741,0,0,35.5,0,0,35.5,0,0,0,0,0,0,78829.13,78864.63,0,21.0,0,32.25,10.0,3.25,0,4.0,0,0,0.0,0,0,0,False,2022
26,001,1,2,2022-01-29,16:25:11,18742,18794,0,0,484.3,0,0,484.3,0,0,0,0,0,0,78864.63,79348.93,0,21.0,0,440.3,10.0,44,0,4.0,0,0,0.0,0,0,0,False,2022
27,001,1,2,2022-01-30,16:54:50,18795,18841,0,0,440.5,0,0,440.5,0,0,0,0,0,0,79348.93,79789.43,0,21.0,0,400.44,10.0,40.06,0,4.0,0,0,0.0,0,0,0,False,2022
28,001,1,2,2022-01-31,15:39:49,18842,18879,0,0,72.12,0,0,72.12,0,0,0,0,0,0,79789.43,79861.55,0.1,21.0,0.02,65.47,10.0,6.53,0,4.0,0,0,0.0,0,0,0,False,2022
29,001,1,2,2022-02-03,16:35:29,18880,18907,0,0,40.7,0,0,40.7,0,0,0,0,0,0,79861.55,79902.25,0,21.0,0,37,10.0,3.7,0,4.0,0,0,0.0,0,0,0,False,2022
30,001,1,2,2022-02-04,17:08:40,18908,18954,0,0,96,0,0,96,0,0,0,0,0,0,79902.25,79998.25,0,21.0,0,87.27,10.0,8.73,0,4.0,0,0,0.0,0,0,0,False,2022
31,001,1,2,2022-02-05,18:02:15,18955,18996,0,0,339.7,0,0,339.7,0,0,0,0,0,0,79998.25,80337.95,0,21.0,0,308.85,10.0,30.85,0,4.0,0,0,0.0,0,0,0,False,2022
32,001,1,2,2022-02-06,15:46:12,18997,19053,0,0,481.9,0,0,481.9,0,0,0,0,0,0,80337.95,80819.85,0,21.0,0,438.1,10.0,43.8,0,4.0,0,0,0.0,0,0,0,False,2022
33,001,1,2,2022-02-09,16:45:08,19054,19081,0,0,56.5,56,0,112.5,0,0,0,0,0,0,80819.85,80876.35,0,21.0,0,102.29,10.0,10.21,0,4.0,0,0,0.0,0,0,0,False,2022
34,001,1,2,2022-02-10,15:08:13,19082,19110,0,0,67.9,44,0,111.9,0,0,0,0,0,0,80876.35,80944.25,0,21.0,0,101.74,10.0,10.16,0,4.0,0,0,0.0,0,0,0,False,2022
35,001,1,2,2022-02-11,17:17:17,19111,19149,0,0,91.7,72.9,0,164.6,0,0,0,0,0,0,80944.25,81035.95,0,21.0,0,149.66,10.0,14.94,0,4.0,0,0,0.0,0,0,0,False,2022
36,001,1,2,2022-02-12,17:23:57,19150,19182,0,0,210.9,53.7,0,264.6,0,0,0,0,0,0,81035.95,81246.85,0,21.0,0,240.56,10.0,24.04,0,4.0,0,0,0.0,0,0,0,False,2022
37,001,1,2,2022-02-13,18:40:16,19183,19247,0,0,599.6,146.2,0,745.8,0,0,0,0,0,0,81246.85,81846.45,1.65,21.0,0.35,676.2,10.0,67.6,0,4.0,0,0,0.0,0,0,0,False,2022
38,001,1,2,2022-02-14,17:16:36,19248,19281,0,0,82.1,70.7,0,152.8,0,0,0,0,0,0,81846.45,81928.55,0,21.0,0,138.94,10.0,13.86,0,4.0,0,0,0.0,0,0,0,False,2022
39,001,1,2,2022-02-15,15:19:18,19282,19310,0,0,79,17.7,0,96.7,0,0,0,0,0,0,81928.55,82007.55,0,21.0,0,87.94,10.0,8.76,0,4.0,0,0,0.0,0,0,0,False,2022
40,001,1,2,2022-02-16,16:04:37,19311,19349,0,0,62,18,0,80,0,0,0,0,0,0,82007.55,82069.55,0,21.0,0,72.71,10.0,7.29,0,4.0,0,0,0.0,0,0,0,False,2022
41,001,1,2,2022-02-17,21:04:37,19350,19390,0,0,96.5,8,0,104.5,0,0,0,0,0,0,82069.55,82166.05,0,21.0,0,94.99,10.0,9.51,0,4.0,0,0,0.0,0,0,0,False,2022
42,001,1,2,2022-02-18,17:10:46,19391,19430,0,0,86.2,37,0,123.2,0,0,0,0,0,0,82166.05,82252.25,0,21.0,0,112.01,10.0,11.19,0,4.0,0,0,0.0,0,0,0,False,2022
43,001,1,2,2022-02-19,18:21:11,19431,19478,0,0,334.02,204,0,538.02,0,0,0,0,0,0,82252.25,82586.27,0.1,21.0,0.02,489,10.0,48.9,0,4.0,0,0,0.0,0,0,0,False,2022
44,001,1,2,2022-02-20,16:11:40,19479,19540,0,0,362,91.5,0,453.5,0,0,0,0,0,0,82586.27,82948.27,0,21.0,0,412.27,10.0,41.23,0,4.0,0,0,0.0,0,0,0,False,2022
45,001,1,2,2022-02-21,16:05:34,19541,19579,0,0,66,20,0,86,0,0,0,0,0,0,82948.27,83014.27,0,21.0,0,78.2,10.0,7.8,0,4.0,0,0,0.0,0,0,0,False,2022
46,001,1,2,2022-02-22,17:03:34,19580,19615,0,0,76,20,0,96,0,0,0,0,0,0,83014.27,83090.27,0,21.0,0,87.29,10.0,8.71,0,4.0,0,0,0.0,0,0,0,False,2022
47,001,1,2,2022-02-23,15:29:38,19616,19656,0,0,45.82,32.5,0,78.32,0,0,0,0,0,0,83090.27,83136.09,0.1,21.0,0.02,71.07,10.0,7.13,0,4.0,0,0,0.0,0,0,0,False,2022
48,001,1,2,2022-02-24,15:46:42,19657,19693,0,0,77.7,55.7,0,133.4,0,0,0,0,0,0,83136.09,83213.79,0,21.0,0,121.32,10.0,12.08,0,4.0,0,0,0.0,0,0,0,False,2022
49,001,1,2,2022-02-25,16:21:40,19694,19713,0,0,25,36.7,0,61.7,0,0,0,0,0,0,83213.79,83238.79,0,21.0,0,56.11,10.0,5.59,0,4.0,0,0,0.0,0,0,0,False,2022
50,001,1,2,2022-02-26,16:22:07,19714,19744,0,0,255.5,0,0,255.5,0,0,0,0,0,0,83238.79,83494.29,5.79,21.0,1.21,225.91,10.0,22.59,0,4.0,0,0,0.0,0,0,0,False,2022
51,001,1,2,2022-02-27,16:46:00,19745,19773,0,0,1422.4,0,0,1422.4,0,0,0,0,0,0,83494.29,84916.69,0,21.0,0,1293.07,10.0,129.33,0,4.0,0,0,0.0,0,0,0,False,2022
52,001,1,2,2022-02-28,16:45:05,19774,19825,0,0,114.8,60,0,174.8,0,0,0,0,0,0,84916.69,85031.49,0,21.0,0,158.93,10.0,15.87,0,4.0,0,0,0.0,0,0,0,False,2022
53,001,1,2,2022-03-01,16:53:46,19826,19859,0,0,70.7,52.9,0,123.6,0,0,0,0,0,0,85031.49,85102.19,0,21.0,0,112.41,10.0,11.19,0,4.0,0,0,0.0,0,0,0,False,2022
54,001,1,2,2022-03-02,16:32:26,19860,19902,0,0,82,113.2,0,195.2,0,0,0,0,0,0,85102.19,85184.19,0,21.0,0,177.47,10.0,17.73,0,4.0,0,0,0.0,0,0,0,False,2022
55,001,1,2,2022-03-03,16:58:46,19903,19940,0,0,55.7,82.5,0,138.2,0,0,0,0,0,0,85184.19,85239.89,0.99,21.0,0.21,124.52,10.0,12.48,0,4.0,0,0,0.0,0,0,0,False,2022
56,001,1,2,2022-03-04,16:32:08,19941,19991,0,0,102.21,50.7,0,152.91,0,0,0,0,0,0,85239.89,85342.1,0.01,21.0,0,139.02,10.0,13.88,0,4.0,0,0,0.0,0,0,0,False,2022
57,001,1,2,2022-03-05,17:29:48,19992,20026,0,0,166.08,16.5,0,182.58,0,0,0,0,0,0,85342.1,85508.18,0.16,21.0,0.02,165.84,10.0,16.56,0,4.0,0,0,0.0,0,0,0,False,2022
58,001,1,2,2022-03-06,18:19:33,20027,20082,0,0,430.1,353.8,0,783.9,0,0,0,0,0,0,85508.18,85938.28,22.31,21.0,4.69,688.1,10.0,68.8,0,4.0,0,0,0.0,0,0,0,False,2022
59,001,1,2,2022-03-07,15:55:47,20083,20114,0,0,68.5,0,0,68.5,0,0,0,0,0,0,85938.28,86006.78,0,21.0,0,62.28,10.0,6.22,0,4.0,0,0,0.0,0,0,0,False,2022
60,001,1,2,2022-03-08,17:50:45,20115,20155,0,0,120.1,77,0,197.1,0,0,0,0,0,0,86006.78,86126.88,0,21.0,0,179.18,10.0,17.92,0,4.0,0,0,0.0,0,0,0,False,2022
61,001,1,2,2022-03-09,16:29:29,20156,20188,0,0,66.1,11.5,0,77.6,0,0,0,0,0,0,86126.88,86192.98,0,21.0,0,70.54,10.0,7.06,0,4.0,0,0,0.0,0,0,0,False,2022
62,001,1,2,2022-03-10,16:26:37,20189,20223,0,0,95.2,40,0,135.2,0,0,0,0,0,0,86192.98,86288.18,0,21.0,0,122.95,10.0,12.25,0,4.0,0,0,0.0,0,0,0,False,2022
63,001,1,2,2022-03-11,15:28:28,20224,20268,0,0,95.5,17.9,0,113.4,0,0,0,0,0,0,86288.18,86383.68,0,21.0,0,103.09,10.0,10.31,0,4.0,0,0,0.0,0,0,0,False,2022
64,001,1,2,2022-03-12,17:14:04,20269,20307,0,0,213.3,75.5,0,288.8,0,0,0,0,0,0,86383.68,86596.98,0,21.0,0,262.58,10.0,26.22,0,4.0,0,0,0.0,0,0,0,False,2022
65,001,1,2,2022-03-13,16:36:17,20308,20365,0,0,424.5,0,0,424.5,0,0,0,0,0,0,86596.98,87021.48,7.6,21.0,1.6,377.56,10.0,37.74,0,4.0,0,0,0.0,0,0,0,False,2022
66,001,1,2,2022-03-14,16:37:03,20366,20396,0,0,75.4,83.7,0,159.1,0,0,0,0,0,0,87021.48,87096.88,0,21.0,0,144.63,10.0,14.47,0,4.0,0,0,0.0,0,0,0,False,2022
67,001,1,2,2022-03-15,17:10:05,20397,20435,0,0,96.9,13.5,0,110.4,0,0,0,0,0,0,87096.88,87193.78,0,21.0,0,100.39,10.0,10.01,0,4.0,0,0,0.0,0,0,0,False,2022
68,001,1,2,2022-03-15,17:20:55,20436,20440,0,0,1.48,0,0,1.48,0,0,0,0,0,0,87193.78,87195.26,0.4,21.0,0.08,0.91,10.0,0.09,0,4.0,0,0,0.0,0,0,0,False,2022
69,001,1,2,2022-03-16,16:30:01,20441,20478,0,0,81.4,43,0,124.4,0,0,0,0,0,0,87195.26,87276.66,0,21.0,0,113.08,10.0,11.32,0,4.0,0,0,0.0,0,0,0,False,2022
70,001,1,2,2022-03-17,17:20:31,20479,20524,0,0,87,69,0,156,0,0,0,0,0,0,87276.66,87363.66,0,21.0,0,141.86,10.0,14.14,0,4.0,0,0,0.0,0,0,0,False,2022
71,001,1,2,2022-03-18,17:13:05,20525,20572,0,0,123,60,0,183,0,0,0,0,0,0,87363.66,87486.66,0,21.0,0,166.41,10.0,16.59,0,4.0,0,0,0.0,0,0,0,False,2022
72,001,1,2,2022-03-19,16:38:08,20573,20637,0,0,482.2,198.4,0,680.6,0,0,0,0,0,0,87486.66,87968.86,0,21.0,0,618.77,10.0,61.83,0,4.0,0,0,0.0,0,0,0,False,2022
73,001,1,2,2022-03-20,15:59:35,20638,20706,0,0,512.6,53.7,0,566.3,0,0,0,0,0,0,87968.86,88481.46,0,21.0,0,514.81,10.0,51.49,0,4.0,0,0,0.0,0,0,0,False,2022
74,001,1,2,2022-03-21,17:37:23,20707,20734,0,0,77,10,0,87,0,0,0,0,0,0,88481.46,88558.46,0,21.0,0,79.11,10.0,7.89,0,4.0,0,0,0.0,0,0,0,False,2022
75,001,1,2,2022-03-22,17:13:19,20735,20759,0,0,46.2,44,0,90.2,0,0,0,0,0,0,88558.46,88604.66,0,21.0,0,81.99,10.0,8.21,0,4.0,0,0,0.0,0,0,0,False,2022
76,001,1,2,2022-03-23,15:39:49,20760,20784,0,0,74.2,47.5,0,121.7,0,0,0,0,0,0,88604.66,88678.86,0,21.0,0,110.62,10.0,11.08,0,4.0,0,0,0.0,0,0,0,False,2022
77,001,1,2,2022-03-24,17:13:11,20785,20829,0,0,96.3,52,0,148.3,0,0,0,0,0,0,88678.86,88775.16,0,21.0,0,134.86,10.0,13.44,0,4.0,0,0,0.0,0,0,0,False,2022
78,001,1,2,2022-03-25,17:28:21,20830,20868,0,0,105.6,81.2,0,186.8,0,0,0,0,0,0,88775.16,88880.76,0,21.0,0,169.87,10.0,16.93,0,4.0,0,0,0.0,0,0,0,False,2022
79,001,1,2,2022-03-26,17:10:36,20869,20912,0,0,322.72,45.2,0,367.92,0,0,0,0,0,0,88880.76,89203.48,0.1,21.0,0.02,334.41,10.0,33.39,0,4.0,0,0,0.0,0,0,0,False,2022
80,001,1,2,2022-03-27,18:12:25,20913,20951,0,0,336.6,38,0,374.6,0,0,0,0,0,0,89203.48,89540.08,0,21.0,0,340.56,10.0,34.04,0,4.0,0,0,0.0,0,0,0,False,2022
81,001,1,2,2022-03-28,14:49:54,20952,20981,0,0,55.9,6,0,61.9,0,0,0,0,0,0,89540.08,89595.98,0,21.0,0,56.28,10.0,5.62,0,4.0,0,0,0.0,0,0,0,False,2022
82,001,1,2,2022-03-29,18:19:06,20982,21023,0,0,78.1,24.5,0,102.6,0,0,0,0,0,0,89595.98,89674.08,0,21.0,0,93.28,10.0,9.32,0,4.0,0,0,0.0,0,0,0,False,2022
83,001,1,2,2022-03-30,16:49:31,21024,21054,0,0,58.2,52,0,110.2,0,0,0,0,0,0,89674.08,89732.28,0,21.0,0,100.2,10.0,10,0,4.0,0,0,0.0,0,0,0,False,2022
84,001,1,2,2022-03-31,16:27:25,21055,21084,0,0,53.9,44.9,0,98.8,0,0,0,0,0,0,89732.28,89786.18,0,21.0,0,89.83,10.0,8.97,0,4.0,0,0,0.0,0,0,0,False,2022
85,001,1,2,2022-04-01,18:29:40,21085,21126,0,0,97,112.2,0,209.2,0,0,0,0,0,0,89786.18,89883.18,0,21.0,0,190.21,10.0,18.99,0,4.0,0,0,0.0,0,0,0,False,2022
86,001,1,2,2022-04-02,17:40:18,21127,21175,0,0,272.6,144.7,0,417.3,0,0,0,0,0,0,89883.18,90155.78,0,21.0,0,379.39,10.0,37.91,0,4.0,0,0,0.0,0,0,0,False,2022
87,001,1,2,2022-04-03,16:59:16,21176,21229,0,0,452.9,0,0,452.9,0,0,0,0,0,0,90155.78,90608.68,0,21.0,0,411.74,10.0,41.16,0,4.0,0,0,0.0,0,0,0,False,2022
88,001,1,2,2022-04-04,16:24:05,21230,21258,0,0,81.7,37,0,118.7,0,0,0,0,0,0,90608.68,90690.38,0,21.0,0,107.93,10.0,10.77,0,4.0,0,0,0.0,0,0,0,False,2022
89,001,1,2,2022-04-05,15:56:14,21259,21281,0,0,37.5,12,0,49.5,0,0,0,0,0,0,90690.38,90727.88,0,21.0,0,45.03,10.0,4.47,0,4.0,0,0,0.0,0,0,0,False,2022
90,001,1,2,2022-04-06,16:00:21,21282,21320,0,0,65.7,120.7,0,186.4,0,0,0,0,0,0,90727.88,90793.58,0,21.0,0,169.49,10.0,16.91,0,4.0,0,0,0.0,0,0,0,False,2022
91,001,1,2,2022-04-07,18:40:44,21321,21353,0,0,66.2,118.7,0,184.9,0,0,0,0,0,0,90793.58,90859.78,0,21.0,0,168.1,10.0,16.8,0,4.0,0,0,0.0,0,0,0,False,2022
92,001,1,2,2022-04-08,20:18:35,21354,21392,0,0,69.7,30,0,99.7,0,0,0,0,0,0,90859.78,90929.48,0,21.0,0,90.65,10.0,9.05,0,4.0,0,0,0.0,0,0,0,False,2022
93,001,1,2,2022-04-09,21:47:31,21393,21465,0,0,475.1,69.5,0,544.6,0,0,0,0,0,0,90929.48,91404.58,6.2,21.0,1.3,488.27,10.0,48.83,0,4.0,0,0,0.0,0,0,0,False,2022
94,001,1,2,2022-04-10,18:49:36,21466,21536,0,0,526.3,166,0,692.3,0,0,0,0,0,0,91404.58,91930.88,0,21.0,0,629.37,10.0,62.93,0,4.0,0,0,0.0,0,0,0,False,2022
95,001,1,2,2022-04-11,17:55:08,21537,21566,0,0,77.1,4.7,0,81.8,0,0,0,0,0,0,91930.88,92007.98,0,21.0,0,74.37,10.0,7.43,0,4.0,0,0,0.0,0,0,0,False,2022
96,001,1,2,2022-04-12,20:02:33,21567,21574,0,0,7,57,0,64,0,0,0,0,0,0,92007.98,92014.98,0,21.0,0,58.17,10.0,5.83,0,4.0,0,0,0.0,0,0,0,False,2022
97,001,1,2,2022-04-13,18:25:56,21575,21599,0,0,27.5,136.5,0,164,0,0,0,0,0,0,92014.98,92042.48,0,21.0,0,149.1,10.0,14.9,0,4.0,0,0,0.0,0,0,0,False,2022
98,001,1,2,2022-04-14,22:04:39,21600,21617,0,0,20.12,136.7,0,156.82,0,0,0,0,0,0,92042.48,92062.6,1.34,21.0,0.28,141.11,10.0,14.09,0,4.0,0,0,0.0,0,0,0,False,2022
99,001,1,2,2022-04-15,21:05:03,21618,21647,0,0,85.2,82.5,0,167.7,0,0,0,0,0,0,92062.6,92147.8,0,21.0,0,152.46,10.0,15.24,0,4.0,0,0,0.0,0,0,0,False,2022
100,001,1,2,2022-04-16,19:08:12,21648,21695,0,0,364.3,60.4,0,424.7,0,0,0,0,0,0,92147.8,92512.1,3.72,21.0,0.78,382.01,10.0,38.19,0,4.0,0,0,0.0,0,0,0,False,2022
101,001,1,2,2022-04-17,17:31:31,21696,21774,0,0,648.6,172.5,0,821.1,0,0,0,0,0,0,92512.1,93160.7,3.47,21.0,0.73,742.67,10.0,74.23,0,4.0,0,0,0.0,0,0,0,False,2022
102,001,1,2,2022-04-18,20:32:01,21775,21821,0,0,91,102.4,0,193.4,0,0,0,0,0,0,93160.7,93251.7,0,21.0,0,175.84,10.0,17.56,0,4.0,0,0,0.0,0,0,0,False,2022
103,001,1,2,2022-04-19,18:39:02,21822,21887,0,0,519.7,169.1,0,688.8,0,0,0,0,0,0,93251.7,93771.4,0,21.0,0,626.25,10.0,62.55,0,4.0,0,0,0.0,0,0,0,False,2022
104,001,1,2,2022-04-21,16:36:37,21888,21908,0,0,38.5,9.5,0,48,0,0,0,0,0,0,93771.4,93809.9,0,21.0,0,43.63,10.0,4.37,0,4.0,0,0,0.0,0,0,0,False,2022
105,001,1,2,2022-04-22,17:25:41,21909,21932,0,0,37,61.7,0,98.7,0,0,0,0,0,0,93809.9,93846.9,0,21.0,0,89.73,10.0,8.97,0,4.0,0,0,0.0,0,0,0,False,2022
106,001,1,2,2022-04-23,17:32:37,21933,21969,0,0,265.2,85.4,0,350.6,0,0,0,0,0,0,93846.9,94112.1,0,21.0,0,318.75,10.0,31.85,0,4.0,0,0,0.0,0,0,0,False,2022
107,001,1,2,2022-04-24,16:04:16,21970,22021,0,0,351.9,81.7,0,433.6,0,0,0,0,0,0,94112.1,94464,17.36,21.0,3.64,375.07,10.0,37.53,0,4.0,0,0,0.0,0,0,0,False,2022
108,001,1,2,2022-04-26,17:15:04,22022,22047,0,0,36,54.5,0,90.5,0,0,0,0,0,0,94464,94500,0,21.0,0,82.3,10.0,8.2,0,4.0,0,0,0.0,0,0,0,False,2022
109,001,1,2,2022-04-27,18:38:11,22048,22087,0,0,66,74.5,0,140.5,0,0,0,0,0,0,94500,94566,0,21.0,0,127.73,10.0,12.77,0,4.0,0,0,0.0,0,0,0,False,2022
110,001,1,2,2022-04-28,17:17:12,22088,22130,0,0,63.2,36.9,0,100.1,0,0,0,0,0,0,94566,94629.2,0,21.0,0,90.99,10.0,9.11,0,4.0,0,0,0.0,0,0,0,False,2022
111,001,1,2,2022-04-29,17:59:50,22131,22171,0,0,79.5,79.5,0,159,0,0,0,0,0,0,94629.2,94708.7,0,21.0,0,144.59,10.0,14.41,0,4.0,0,0,0.0,0,0,0,False,2022
112,001,1,2,2022-04-30,18:19:41,22172,22226,0,0,322.5,118,0,440.5,0,0,0,0,0,0,94708.7,95031.2,0,21.0,0,400.5,10.0,40,0,4.0,0,0,0.0,0,0,0,False,2022
113,001,1,2,2022-05-01,16:42:35,22227,22290,0,0,346.7,154,0,500.7,0,0,0,0,0,0,95031.2,95377.9,0,21.0,0,455.16,10.0,45.54,0,4.0,0,0,0.0,0,0,0,False,2022
114,001,1,2,2022-05-02,16:31:21,22291,22338,0,0,258.7,156.3,0,415,0,0,0,0,0,0,95377.9,95636.6,0,21.0,0,377.3,10.0,37.7,0,4.0,0,0,0.0,0,0,0,False,2022
115,001,1,2,2022-05-03,14:29:26,22339,22381,0,0,86,56.5,0,142.5,0,0,0,0,0,0,95636.6,95722.6,0,21.0,0,129.57,10.0,12.93,0,4.0,0,0,0.0,0,0,0,False,2022
116,001,1,2,2022-05-04,17:17:50,22382,22420,0,0,74,44.7,0,118.7,0,0,0,0,0,0,95722.6,95796.6,0,21.0,0,107.95,10.0,10.75,0,4.0,0,0,0.0,0,0,0,False,2022
117,001,1,2,2022-05-05,17:24:28,22421,22454,0,0,66.12,11,0,77.12,0,0,0,0,0,0,95796.6,95862.72,0.1,21.0,0.02,70.02,10.0,6.98,0,4.0,0,0,0.0,0,0,0,False,2022
118,001,1,2,2022-05-06,17:41:05,22455,22501,0,0,77.2,83.3,0,160.5,0,0,0,0,0,0,95862.72,95939.92,0,21.0,0,145.95,10.0,14.55,0,4.0,0,0,0.0,0,0,0,False,2022
119,001,1,2,2022-05-07,18:27:24,22502,22576,0,0,408.4,170.7,0,579.1,0,0,0,0,0,0,95939.92,96348.32,0,21.0,0,526.45,10.0,52.65,0,4.0,0,0,0.0,0,0,0,False,2022
120,001,1,2,2022-05-08,17:47:01,22577,22662,0,0,511.5,184,0,695.5,0,0,0,0,0,0,96348.32,96859.82,0,21.0,0,632.3,10.0,63.2,0,4.0,0,0,0.0,0,0,0,False,2022
121,001,1,2,2022-05-09,16:43:08,22663,22696,0,0,95.52,38,0,133.52,0,0,0,0,0,0,96859.82,96955.34,0.1,21.0,0.02,121.29,10.0,12.11,0,4.0,0,0,0.0,0,0,0,False,2022
122,001,1,2,2022-05-10,16:07:00,22697,22725,0,0,117.9,65.4,0,183.3,0,0,0,0,0,0,96955.34,97073.24,0,21.0,0,166.65,10.0,16.65,0,4.0,0,0,0.0,0,0,0,False,2022
123,001,1,2,2022-05-11,16:53:34,22726,22746,0,0,54,17,0,71,0,0,0,0,0,0,97073.24,97127.24,0,21.0,0,64.58,10.0,6.42,0,4.0,0,0,0.0,0,0,0,False,2022
124,001,1,2,2022-05-12,16:41:47,22747,22777,0,0,77.5,86.5,0,164,0,0,0,0,0,0,97127.24,97204.74,0,21.0,0,149.12,10.0,14.88,0,4.0,0,0,0.0,0,0,0,False,2022
125,001,1,2,2022-05-13,16:25:59,22778,22811,0,0,89,140.2,0,229.2,0,0,0,0,0,0,97204.74,97293.74,0.83,21.0,0.17,207.49,10.0,20.71,0,4.0,0,0,0.0,0,0,0,False,2022
126,001,1,2,2022-05-14,17:41:13,22812,22851,0,0,228.2,194.2,0,422.4,0,0,0,0,0,0,97293.74,97521.94,0,21.0,0,384.03,10.0,38.37,0,4.0,0,0,0.0,0,0,0,False,2022
127,001,1,2,2022-05-15,17:16:26,22852,22932,0,0,512,176.5,0,688.5,0,0,0,0,0,0,97521.94,98033.94,0,21.0,0,625.89,10.0,62.61,0,4.0,0,0,0.0,0,0,0,False,2022
128,001,1,2,2022-05-16,15:48:07,22933,22969,0,0,72.2,35.7,0,107.9,0,0,0,0,0,0,98033.94,98106.14,0,21.0,0,98.1,10.0,9.8,0,4.0,0,0,0.0,0,0,0,False,2022
129,001,1,2,2022-05-18,17:24:03,22970,23008,0,0,53.7,28.5,0,82.2,0,0,0,0,0,0,98106.14,98159.84,0,21.0,0,74.72,10.0,7.48,0,4.0,0,0,0.0,0,0,0,False,2022
130,001,1,2,2022-05-19,16:47:50,23009,23026,0,0,32,14.5,0,46.5,0,0,0,0,0,0,98159.84,98191.84,0,21.0,0,42.27,10.0,4.23,0,4.0,0,0,0.0,0,0,0,False,2022
131,001,1,2,2022-05-20,21:26:05,23027,23049,0,0,19.12,124.7,0,143.82,0,0,0,0,0,0,98191.84,98210.96,0.1,21.0,0.02,130.65,10.0,13.05,0,4.0,0,0,0.0,0,0,0,False,2022
132,001,1,2,2022-05-21,19:18:03,23050,23095,0,0,468.5,70.5,0,539,0,0,0,0,0,0,98210.96,98679.46,4.55,21.0,0.95,485,10.0,48.5,0,4.0,0,0,0.0,0,0,0,False,2022
133,001,1,2,2022-05-22,17:23:14,23096,23145,0,0,376.7,138.1,0,514.8,0,0,0,0,0,0,98679.46,99056.16,1.24,21.0,0.26,466.67,10.0,46.63,0,4.0,0,0,0.0,0,0,0,False,2022
134,001,1,2,2022-05-22,17:31:47,23146,23147,0,0,1.12,0,0,1.12,0,0,0,0,0,0,99060.16,99061.28,0.1,21.0,0.02,0.91,10.0,0.09,0,4.0,0,0,0.0,0,0,0,False,2022
135,001,1,2,2022-05-23,16:13:02,23148,23167,0,0,33.62,18,0,51.62,0,0,0,0,0,0,99061.28,99094.9,0.1,21.0,0.02,46.84,10.0,4.66,0,4.0,0,0,0.0,0,0,0,False,2022
136,001,1,2,2022-05-24,15:27:29,23168,23196,0,0,52.18,22.5,0,74.68,0,0,0,0,0,0,99094.9,99147.08,0.4,21.0,0.08,67.5,10.0,6.7,0,4.0,0,0,0.0,0,0,0,False,2022
137,001,1,2,2022-05-25,17:28:14,23197,23226,0,0,52.24,57,0,109.24,0,0,0,0,0,0,99147.08,99199.32,0.2,21.0,0.04,99.1,10.0,9.9,0,4.0,0,0,0.0,0,0,0,False,2022
138,001,1,2,2022-05-26,16:50:34,23227,23257,0,0,58,50.7,0,108.7,0,0,0,0,0,0,99199.32,99257.32,0,21.0,0,98.85,10.0,9.85,0,4.0,0,0,0.0,0,0,0,False,2022
139,001,1,2,2022-05-27,19:09:38,23258,23317,0,0,102.4,158.2,0,260.6,0,0,0,0,0,0,99257.32,99359.72,0,21.0,0,236.94,10.0,23.66,0,4.0,0,0,0.0,0,0,0,False,2022
140,001,1,2,2022-05-28,17:19:27,23318,23365,0,0,340.5,85.5,0,426,0,0,0,0,0,0,99359.72,99700.22,0,21.0,0,387.28,10.0,38.72,0,4.0,0,0,0.0,0,0,0,False,2022
141,001,1,2,2022-05-29,16:45:16,23366,23416,0,0,465.1,103,0,568.1,0,0,0,0,0,0,99700.22,100165.32,0,21.0,0,516.47,10.0,51.63,0,4.0,0,0,0.0,0,0,0,False,2022
142,001,1,2,2022-05-30,17:01:57,23417,23459,0,0,90.2,37.2,0,127.4,0,0,0,0,0,0,100165.32,100255.52,0,21.0,0,115.87,10.0,11.53,0,4.0,0,0,0.0,0,0,0,False,2022
143,001,1,2,2022-05-31,16:03:03,23460,23466,0,0,36,0,0,36,0,0,0,0,0,0,100255.52,100291.52,0,21.0,0,32.73,10.0,3.27,0,4.0,0,0,0.0,0,0,0,False,2022
144,001,1,2,2022-06-01,16:12:14,23467,23489,0,0,44.7,0,0,44.7,0,0,0,0,0,0,100291.52,100336.22,0,21.0,0,40.66,10.0,4.04,0,4.0,0,0,0.0,0,0,0,False,2022
145,001,1,2,2022-06-02,17:12:51,23490,23512,0,0,41.5,35.1,0,76.6,0,0,0,0,0,0,100336.22,100377.72,0,21.0,0,69.66,10.0,6.94,0,4.0,0,0,0.0,0,0,0,False,2022
146,001,1,2,2022-06-03,16:27:55,23513,23554,0,0,71,35.7,0,106.7,0,0,0,0,0,0,100377.72,100448.72,0,21.0,0,97.02,10.0,9.68,0,4.0,0,0,0.0,0,0,0,False,2022
147,001,1,2,2022-06-04,16:36:19,23555,23586,0,0,202.4,38,0,240.4,0,0,0,0,0,0,100448.72,100651.12,0,21.0,0,218.57,10.0,21.83,0,4.0,0,0,0.0,0,0,0,False,2022
148,001,1,2,2022-06-05,16:57:53,23587,23640,0,0,302.9,116.7,0,419.6,0,0,0,0,0,0,100651.12,100954.02,0,21.0,0,381.46,10.0,38.14,0,4.0,0,0,0.0,0,0,0,False,2022
149,001,1,2,2022-06-06,17:00:47,23641,23677,0,0,58,107.7,0,165.7,0,0,0,0,0,0,100954.02,101012.02,0,21.0,0,150.63,10.0,15.07,0,4.0,0,0,0.0,0,0,0,False,2022
150,001,1,2,2022-06-07,17:07:48,23678,23710,0,0,40,71.7,0,111.7,0,0,0,0,0,0,101012.02,101052.02,0,21.0,0,101.57,10.0,10.13,0,4.0,0,0,0.0,0,0,0,False,2022
151,001,1,2,2022-06-08,17:32:20,23711,23753,0,0,72.1,88.5,0,160.6,0,0,0,0,0,0,101052.02,101124.12,0,21.0,0,145.99,10.0,14.61,0,4.0,0,0,0.0,0,0,0,False,2022
152,001,1,2,2022-06-09,18:16:14,23754,23793,0,0,241,82.9,0,323.9,0,0,0,0,0,0,101124.12,101365.12,0,21.0,0,294.45,10.0,29.45,0,4.0,0,0,0.0,0,0,0,False,2022
153,001,1,2,2022-06-10,17:29:21,23794,23829,0,0,87.5,80.7,0,168.2,0,0,0,0,0,0,101365.12,101452.62,0,21.0,0,152.96,10.0,15.24,0,4.0,0,0,0.0,0,0,0,False,2022
154,001,1,2,2022-06-11,17:31:01,23830,23898,0,0,355.58,104.5,0,460.08,0,0,0,0,0,0,101452.62,101808.2,8.66,21.0,1.82,408.73,10.0,40.87,0,4.0,0,0,0.0,0,0,0,False,2022
155,001,1,2,2022-06-12,17:37:34,23899,23962,0,0,555.2,192.7,0,747.9,0,0,0,0,0,0,101808.2,102363.4,0,21.0,0,679.96,10.0,67.94,0,4.0,0,0,0.0,0,0,0,False,2022
156,001,1,2,2022-06-13,16:41:53,23963,24009,0,0,101.62,121,0,222.62,0,0,0,0,0,0,102363.4,102465.02,0.1,21.0,0.02,202.28,10.0,20.22,0,4.0,0,0,0.0,0,0,0,False,2022
157,001,1,2,2022-06-14,17:26:22,24010,24063,0,0,62.78,53,0,115.78,0,0,0,0,0,0,102465.02,102527.8,1.9,21.0,0.38,103.2,10.0,10.3,0,4.0,0,0,0.0,0,0,0,False,2022
158,001,1,2,2022-06-16,18:02:25,24064,24126,0,0,101,173.2,0,274.2,0,0,0,0,0,0,102527.8,102628.8,0,21.0,0,249.28,10.0,24.92,0,4.0,0,0,0.0,0,0,0,False,2022
159,001,1,2,2022-06-17,19:36:12,24127,24173,0,0,84.5,152.9,0,237.4,0,0,0,0,0,0,102628.8,102713.3,0,21.0,0,215.87,10.0,21.53,0,4.0,0,0,0.0,0,0,0,False,2022
160,001,1,2,2022-06-18,18:33:32,24174,24225,0,0,317.98,118.5,0,436.48,0,0,0,0,0,0,102713.3,103031.28,0.4,21.0,0.08,396.38,10.0,39.62,0,4.0,0,0,0.0,0,0,0,False,2022
161,001,1,2,2022-06-19,18:41:05,24226,24288,0,0,377.24,193.2,0,570.44,0,0,0,0,0,0,103031.28,103408.52,0.2,21.0,0.04,518.4,10.0,51.8,0,4.0,0,0,0.0,0,0,0,False,2022
162,001,1,2,2022-06-20,17:43:15,24289,24327,0,0,73.5,44,0,117.5,0,0,0,0,0,0,103408.52,103482.02,0,21.0,0,106.82,10.0,10.68,0,4.0,0,0,0.0,0,0,0,False,2022
163,001,1,2,2022-06-21,15:34:34,24328,24346,0,0,12.72,40.5,0,53.22,0,0,0,0,0,0,103482.02,103494.74,0.6,21.0,0.12,47.74,10.0,4.76,0,4.0,0,0,0.0,0,0,0,False,2022
164,001,1,2,2022-06-22,15:58:54,24347,24373,0,0,51,30.7,0,81.7,0,0,0,0,0,0,103494.74,103545.74,0,21.0,0,74.3,10.0,7.4,0,4.0,0,0,0.0,0,0,0,False,2022
165,001,1,2,2022-06-23,16:53:18,24374,24403,0,0,66.7,26,0,92.7,0,0,0,0,0,0,103545.74,103612.44,0,21.0,0,84.3,10.0,8.4,0,4.0,0,0,0.0,0,0,0,False,2022
166,001,1,2,2022-06-24,21:22:28,24404,24453,0,0,51.72,63.5,0,115.22,0,0,0,0,0,0,103612.44,103664.16,0.6,21.0,0.12,104.09,10.0,10.41,0,4.0,0,0,0.0,0,0,0,False,2022
167,001,1,2,2022-06-25,20:44:41,24454,24500,0,0,315.62,71.2,0,386.82,0,0,0,0,0,0,103664.16,103979.78,0.1,21.0,0.02,351.54,10.0,35.16,0,4.0,0,0,0.0,0,0,0,False,2022
168,001,1,2,2022-06-26,17:55:51,24501,24570,0,0,543.74,169,0,712.74,0,0,0,0,0,0,103979.78,104523.52,0.2,21.0,0.04,647.74,10.0,64.76,0,4.0,0,0,0.0,0,0,0,False,2022
169,001,1,2,2022-06-27,15:22:10,24571,24603,0,0,45.62,46.5,0,92.12,0,0,0,0,0,0,104523.52,104569.14,0.1,21.0,0.02,83.64,10.0,8.36,0,4.0,0,0,0.0,0,0,0,False,2022
170,001,1,2,2022-06-29,17:23:51,24604,24638,0,0,51.5,72.4,0,123.9,0,0,0,0,0,0,104569.14,104620.64,0,21.0,0,112.65,10.0,11.25,0,4.0,0,0,0.0,0,0,0,False,2022
171,001,1,2,2022-06-30,16:23:00,24639,24660,0,0,30,75,0,105,0,0,0,0,0,0,104620.64,104650.64,0,21.0,0,95.47,10.0,9.53,0,4.0,0,0,0.0,0,0,0,False,2022
172,001,1,2,2022-07-01,20:59:12,24661,24703,0,0,50,141.5,0,191.5,0,0,0,0,0,0,104650.64,104700.64,0,21.0,0,174.07,10.0,17.43,0,4.0,0,0,0.0,0,0,0,False,2022
173,001,1,2,2022-07-02,18:42:02,24704,24752,0,0,333,135.5,0,468.5,0,0,0,0,0,0,104700.64,105033.64,0,21.0,0,425.9,10.0,42.6,0,4.0,0,0,0.0,0,0,0,False,2022
174,001,1,2,2022-07-03,16:55:00,24753,24815,0,0,333.48,249.1,0,582.58,0,0,0,0,0,0,105033.64,105367.12,9.49,21.0,1.99,519.16,10.0,51.94,0,4.0,0,0,0.0,0,0,0,False,2022
175,001,1,2,2022-07-04,14:37:17,24816,24843,0,0,37.62,26.2,0,63.82,0,0,0,0,0,0,105367.12,105404.74,0.1,21.0,0.02,57.92,10.0,5.78,0,4.0,0,0,0.0,0,0,0,False,2022
176,001,1,2,2022-07-06,16:55:11,24844,24881,0,0,68.6,19.5,0,88.1,0,0,0,0,0,0,105404.74,105473.34,0.5,21.0,0.1,79.58,10.0,7.92,0,4.0,0,0,0.0,0,0,0,False,2022
177,001,1,2,2022-07-07,17:13:29,24882,24913,0,0,39.48,122.5,0,161.98,0,0,0,0,0,0,105473.34,105512.82,0.4,21.0,0.08,146.83,10.0,14.67,0,4.0,0,0,0.0,0,0,0,False,2022
178,001,1,2,2022-07-08,18:43:07,24914,24955,0,0,53,138,0,191,0,0,0,0,0,0,105512.82,105565.82,0,21.0,0,173.63,10.0,17.37,0,4.0,0,0,0.0,0,0,0,False,2022
179,001,1,2,2022-07-09,19:03:52,24956,25007,0,0,374.7,279.4,0,654.1,0,0,0,0,0,0,105565.82,105940.52,0,21.0,0,594.65,10.0,59.45,0,4.0,0,0,0.0,0,0,0,False,2022
180,001,1,2,2022-07-10,17:12:18,25008,25070,0,0,454.64,228.4,0,683.04,0,0,0,0,0,0,105940.52,106395.16,0.2,21.0,0.04,620.75,10.0,62.05,0,4.0,0,0,0.0,0,0,0,False,2022
181,001,1,2,2022-07-11,18:29:40,25071,25094,0,0,50.12,34,0,84.12,0,0,0,0,0,0,106395.16,106445.28,0.1,21.0,0.02,76.39,10.0,7.61,0,4.0,0,0,0.0,0,0,0,False,2022
182,001,1,2,2022-07-13,18:11:24,25095,25119,0,0,42.12,56,0,98.12,0,0,0,0,0,0,106445.28,106487.4,0.1,21.0,0.02,89.12,10.0,8.88,0,4.0,0,0,0.0,0,0,0,False,2022
183,001,1,2,2022-07-14,17:53:08,25120,25145,0,0,52.62,63.5,0,116.12,0,0,0,0,0,0,106487.4,106540.02,0.1,21.0,0.02,105.48,10.0,10.52,0,4.0,0,0,0.0,0,0,0,False,2022
184,001,1,2,2022-07-15,18:00:31,25146,25185,0,0,76,125.2,0,201.2,0,0,0,0,0,0,106540.02,106616.02,0,21.0,0,182.97,10.0,18.23,0,4.0,0,0,0.0,0,0,0,False,2022
185,001,1,2,2022-07-16,14:37:36,25186,25223,0,0,217.94,86.5,0,304.44,0,0,0,0,0,0,106616.02,106833.96,0.2,21.0,0.04,276.56,10.0,27.64,0,4.0,0,0,0.0,0,0,0,False,2022
186,001,1,2,2022-07-17,16:27:52,25224,25288,0,0,364.86,156,0,520.86,0,0,0,0,0,0,106833.96,107198.82,0.3,21.0,0.06,473.21,10.0,47.29,0,4.0,0,0,0.0,0,0,0,False,2022
187,001,1,2,2022-07-18,16:37:10,25289,25317,0,0,43,96.5,0,139.5,0,0,0,0,0,0,107198.82,107241.82,0,21.0,0,126.84,10.0,12.66,0,4.0,0,0,0.0,0,0,0,False,2022
188,001,1,2,2022-07-20,20:44:55,25318,25350,0,0,74.5,24.2,0,98.7,0,0,0,0,0,0,107241.82,107316.32,0,21.0,0,89.75,10.0,8.95,0,4.0,0,0,0.0,0,0,0,False,2022
189,001,1,2,2022-07-21,16:55:52,25351,25385,0,0,56.74,14.7,0,71.44,0,0,0,0,0,0,107316.32,107373.06,0.2,21.0,0.04,64.72,10.0,6.48,0,4.0,0,0,0.0,0,0,0,False,2022
190,001,1,2,2022-07-22,19:25:23,25386,25430,0,0,106,10,0,116,0,0,0,0,0,0,107373.06,107479.06,0,21.0,0,105.47,10.0,10.53,0,4.0,0,0,0.0,0,0,0,False,2022
191,001,1,2,2022-07-23,17:51:36,25431,25468,0,0,316.7,34.5,0,351.2,0,0,0,0,0,0,107479.06,107795.76,0,21.0,0,319.27,10.0,31.93,0,4.0,0,0,0.0,0,0,0,False,2022
192,001,1,2,2022-07-24,15:15:12,25469,25503,0,0,191.4,18,0,209.4,0,0,0,0,0,0,107795.76,107987.16,0,21.0,0,190.38,10.0,19.02,0,4.0,0,0,0.0,0,0,0,False,2022
193,001,1,2,2022-07-25,15:21:21,25504,25529,0,0,39,38.5,0,77.5,0,0,0,0,0,0,107987.16,108026.16,0,21.0,0,70.49,10.0,7.01,0,4.0,0,0,0.0,0,0,0,False,2022
194,001,1,2,2022-07-26,15:22:28,25530,25548,0,0,142,12,0,154,0,0,0,0,0,0,108026.16,108168.16,0,21.0,0,140,10.0,14,0,4.0,0,0,0.0,0,0,0,False,2022
195,001,1,2,2022-07-27,14:59:54,25549,25567,0,0,90.7,0,0,90.7,0,0,0,0,0,0,108168.16,108258.86,0,21.0,0,82.47,10.0,8.23,0,4.0,0,0,0.0,0,0,0,False,2022
196,001,1,2,2022-09-06,19:10:06,25568,25576,0,0,14.02,53.7,0,67.72,0,0,0,0,0,0,108258.86,108272.88,2.08,21.0,0.44,59.28,10.0,5.92,0,4.0,0,0,0.0,0,0,0,False,2022
197,001,1,2,2022-09-07,22:37:32,25577,25586,0,0,30.3,49,0,79.3,0,0,0,0,0,0,108272.88,108303.18,4.46,21.0,0.94,67.18,10.0,6.72,0,4.0,0,0,0.0,0,0,0,False,2022
198,001,1,2,2022-09-08,21:17:56,25587,25592,0,0,0,62.7,0,62.7,0,0,0,0,0,0,108303.18,108303.18,0,21.0,0,57.01,10.0,5.69,0,4.0,0,0,0.0,0,0,0,False,2022
199,001,1,2,2022-09-09,21:50:11,25593,25600,0,0,1.5,76,0,77.5,0,0,0,0,0,0,108303.18,108304.68,1.24,21.0,0.26,69.09,10.0,6.91,0,4.0,0,0,0.0,0,0,0,False,2022
200,001,1,2,2022-09-10,23:35:28,25601,25631,0,0,266,78,0,344,0,0,0,0,0,0,108304.68,108570.68,8.68,21.0,1.82,303.16,10.0,30.34,0,4.0,0,0,0.0,0,0,0,False,2022
201,001,1,2,2022-09-11,20:27:28,25632,25666,0,0,380.3,57.8,0,438.1,0,0,0,0,0,0,108570.68,108950.98,38.84,21.0,8.16,355.56,10.0,35.54,0,4.0,0,0,0.0,0,0,0,False,2022
202,001,1,2,2022-09-12,20:41:43,25667,25687,0,0,72.4,72.4,0,144.8,0,0,0,0,0,0,108950.98,109023.38,0,21.0,0,131.61,10.0,13.19,0,4.0,0,0,0.0,0,0,0,False,2022
203,001,1,2,2022-09-13,18:18:30,25688,25700,0,0,111.1,60.4,0,171.5,0,0,0,0,0,0,109023.38,109134.48,5.79,21.0,1.21,149.55,10.0,14.95,0,4.0,0,0,0.0,0,0,0,False,2022
204,001,1,2,2022-09-14,20:47:25,25701,25709,0,0,7,75.9,0,82.9,0,0,0,0,0,0,109134.48,109141.48,6.2,21.0,1.3,68.56,10.0,6.84,0,4.0,0,0,0.0,0,0,0,False,2022
205,001,1,2,2022-09-15,20:22:34,25710,25716,0,0,13.5,36.5,0,50,0,0,0,0,0,0,109141.48,109154.98,2.48,21.0,0.52,42.73,10.0,4.27,0,4.0,0,0,0.0,0,0,0,False,2022
206,001,1,2,2022-09-16,22:03:50,25717,25725,0,0,60.5,46.2,0,106.7,0,0,0,0,0,0,109154.98,109215.48,3.72,21.0,0.78,92.92,10.0,9.28,0,4.0,0,0,0.0,0,0,0,False,2022
207,001,1,2,2022-09-18,00:10:53,25726,25794,0,0,649.3,231.1,0,880.4,0,0,0,0,0,0,109215.48,109864.78,31.83,21.0,6.67,765.4,10.0,76.5,0,4.0,0,0,0.0,0,0,0,False,2022
208,001,1,2,2022-09-18,17:58:49,25795,25869,0,0,699.4,72.4,0,771.8,0,0,0,0,0,0,109864.78,110564.18,15.04,21.0,3.16,685.12,10.0,68.48,0,4.0,0,0,0.0,0,0,0,False,2022
209,001,1,2,2022-09-19,18:03:35,25870,25901,0,0,198,12,0,210,0,0,0,0,0,0,110564.18,110762.18,2.48,21.0,0.52,188.17,10.0,18.83,0,4.0,0,0,0.0,0,0,0,False,2022
210,001,1,2,2022-09-21,19:55:53,25902,25906,0,0,5,44.4,0,49.4,0,0,0,0,0,0,110762.18,110767.18,0,21.0,0,44.92,10.0,4.48,0,4.0,0,0,0.0,0,0,0,False,2022
211,001,1,2,2022-09-22,22:07:54,25907,25920,0,0,39,105,0,144,0,0,0,0,0,0,110767.18,110806.18,8.27,21.0,1.73,121.82,10.0,12.18,0,4.0,0,0,0.0,0,0,0,False,2022
212,001,1,2,2022-09-23,21:25:40,25921,25942,0,0,125.5,57.4,0,182.9,0,0,0,0,0,0,110806.18,110931.68,1.24,21.0,0.26,164.9,10.0,16.5,0,4.0,0,0,0.0,0,0,0,False,2022
213,001,1,2,2022-09-24,23:02:09,25943,26004,0,0,405.96,245.2,0,651.16,0,0,0,0,0,0,110931.68,111337.64,10.63,21.0,2.23,580.27,10.0,58.03,0,4.0,0,0,0.0,0,0,0,False,2022
214,001,1,2,2022-09-25,21:33:01,26005,26050,0,0,391.7,240.1,0,631.8,0,0,0,0,0,0,111337.64,111729.34,46.29,21.0,9.71,523.48,10.0,52.32,0,4.0,0,0,0.0,0,0,0,False,2022
215,001,1,2,2022-09-26,18:27:17,26051,26068,0,0,98.5,49.3,0,147.8,0,0,0,0,0,0,111729.34,111827.84,4.96,21.0,1.04,128.91,10.0,12.89,0,4.0,0,0,0.0,0,0,0,False,2022
216,001,1,2,2022-09-28,17:20:09,26069,26077,0,0,1,77.9,0,78.9,0,0,0,0,0,0,111827.84,111828.84,2.48,21.0,0.52,68.99,10.0,6.91,0,4.0,0,0,0.0,0,0,0,False,2022
217,001,1,2,2022-09-29,20:28:58,26078,26089,0,0,42,134.2,0,176.2,0,0,0,0,0,0,111828.84,111870.84,2.48,21.0,0.52,157.47,10.0,15.73,0,4.0,0,0,0.0,0,0,0,False,2022
218,001,1,2,2022-09-30,23:33:55,26090,26100,0,0,57.5,176.6,0,234.1,0,0,0,0,0,0,111870.84,111928.34,1.24,21.0,0.26,211.44,10.0,21.16,0,4.0,0,0,0.0,0,0,0,False,2022
219,001,1,2,2022-10-01,21:24:29,26101,26132,0,0,260.8,240.3,0,501.1,0,0,0,0,0,0,111928.34,112189.14,86.36,21.0,18.14,360.54,10.0,36.06,0,4.0,0,0,0.0,0,0,0,False,2022
220,001,1,2,2022-10-02,18:33:21,26133,26178,0,0,325.22,396,0,721.22,0,0,0,0,0,0,112189.14,112514.36,28.05,21.0,5.87,624.86,10.0,62.44,0,4.0,0,0,0.0,0,0,0,False,2022
221,001,1,2,2022-10-03,18:02:25,26179,26195,0,0,72.5,140.2,0,212.7,0,0,0,0,0,0,112514.36,112586.86,0,21.0,0,193.37,10.0,19.33,0,4.0,0,0,0.0,0,0,0,False,2022
222,001,1,2,2022-10-05,20:16:26,26196,26208,0,0,67.3,87.7,0,155,0,0,0,0,0,0,112586.86,112654.16,3.31,21.0,0.69,137.26,10.0,13.74,0,4.0,0,0,0.0,0,0,0,False,2022
223,001,1,2,2022-10-06,22:05:16,26209,26240,0,0,130.6,115.2,0,245.8,0,0,0,0,0,0,112654.16,112784.76,7.44,21.0,1.56,215.28,10.0,21.52,0,4.0,0,0,0.0,0,0,0,False,2022
224,001,1,2,2022-10-08,00:36:45,26241,26284,0,0,239.6,173.8,0,413.4,0,0,0,0,0,0,112784.76,113024.36,5.79,21.0,1.21,369.46,10.0,36.94,0,4.0,0,0,0.0,0,0,0,False,2022
225,001,1,2,2022-10-08,23:56:11,26285,26336,0,0,372,195.5,0,567.5,0,0,0,0,0,0,113024.36,113396.36,18.61,21.0,3.89,495.45,10.0,49.55,0,4.0,0,0,0.0,0,0,0,False,2022
226,001,1,2,2022-10-09,18:01:44,26337,26388,0,0,368.62,239.8,0,608.42,0,0,0,0,0,0,113396.36,113764.98,29.04,21.0,6.08,521.17,10.0,52.13,0,4.0,0,0,0.0,0,0,0,False,2022
227,001,1,2,2022-10-10,17:12:18,26389,26402,0,0,58.7,96.7,0,155.4,0,0,0,0,0,0,113764.98,113823.68,8.02,21.0,1.68,132.45,10.0,13.25,0,4.0,0,0,0.0,0,0,0,False,2022
228,001,1,2,2022-10-11,21:27:04,26403,26418,0,0,97.4,100.3,0,197.7,0,0,0,0,0,0,113823.68,113921.08,5.79,21.0,1.21,173.37,10.0,17.33,0,4.0,0,0,0.0,0,0,0,False,2022
229,001,1,2,2022-10-12,18:29:39,26419,26437,0,0,97.1,339.6,0,436.7,0,0,0,0,0,0,113921.08,114018.18,4.79,21.0,1.01,391.73,10.0,39.17,0,4.0,0,0,0.0,0,0,0,False,2022
230,001,1,2,2022-10-13,21:53:04,26438,26465,0,0,160.6,191,0,351.6,0,0,0,0,0,0,114018.18,114178.78,21.9,21.0,4.6,295.54,10.0,29.56,0,4.0,0,0,0.0,0,0,0,False,2022
231,001,1,2,2022-10-14,21:53:20,26466,26509,0,0,158.8,205.9,0,364.7,0,0,0,0,0,0,114178.78,114337.58,1.24,21.0,0.26,330.21,10.0,32.99,0,4.0,0,0,0.0,0,0,0,False,2022
232,001,1,2,2022-10-15,21:38:34,26510,26579,0,0,510.3,315.5,0,825.8,0,0,0,0,0,0,114337.58,114847.88,53.73,21.0,11.27,691.66,10.0,69.14,0,4.0,0,0,0.0,0,0,0,False,2022
233,001,1,2,2022-10-16,19:50:47,26580,26611,0,0,327,334,0,661,0,0,0,0,0,0,114847.88,115174.88,56.62,21.0,11.88,538.61,10.0,53.89,0,4.0,0,0,0.0,0,0,0,False,2022
234,001,1,2,2022-10-17,17:13:37,26612,26622,0,0,62.5,73.2,0,135.7,0,0,0,0,0,0,115174.88,115237.38,10.08,21.0,2.12,112.29,10.0,11.21,0,4.0,0,0,0.0,0,0,0,False,2022
235,001,1,2,2022-10-18,15:51:58,26623,26630,0,0,96.5,64.3,0,160.8,0,0,0,0,0,0,115237.38,115333.88,3.31,21.0,0.69,142.54,10.0,14.26,0,4.0,0,0,0.0,0,0,0,False,2022
236,001,1,2,2022-10-19,17:27:55,26631,26638,0,0,0,103.6,0,103.6,0,0,0,0,0,0,115333.88,115333.88,0,21.0,0,94.18,10.0,9.42,0,4.0,0,0,0.0,0,0,0,False,2022
237,001,1,2,2022-10-20,18:54:24,26639,26656,0,0,55.2,180.2,0,235.4,0,0,0,0,0,0,115333.88,115389.08,0,21.0,0,214.01,10.0,21.39,0,4.0,0,0,0.0,0,0,0,False,2022
238,001,1,2,2022-10-21,20:38:19,26657,26670,0,0,55,136.5,0,191.5,0,0,0,0,0,0,115389.08,115444.08,3.31,21.0,0.69,170.45,10.0,17.05,0,4.0,0,0,0.0,0,0,0,False,2022
239,001,1,2,2022-10-22,20:17:55,26671,26703,0,0,281.1,287.2,0,568.3,0,0,0,0,0,0,115444.08,115725.18,67.03,21.0,14.07,442.91,10.0,44.29,0,4.0,0,0,0.0,0,0,0,False,2022
240,001,1,2,2022-10-23,23:46:39,26704,26732,0,0,392.6,333.9,0,726.5,0,0,0,0,0,0,115725.18,116117.78,17.78,21.0,3.72,640.91,10.0,64.09,0,4.0,0,0,0.0,0,0,0,False,2022
241,001,1,2,2022-10-24,19:03:10,26733,26743,0,0,71.3,88,0,159.3,0,0,0,0,0,0,116117.78,116189.08,8.27,21.0,1.73,135.73,10.0,13.57,0,4.0,0,0,0.0,0,0,0,False,2022
242,001,1,2,2022-10-25,17:07:50,26744,26758,0,0,138.6,101.8,0,240.4,0,0,0,0,0,0,116189.08,116327.68,26.03,21.0,5.47,189.93,10.0,18.97,0,4.0,0,0,0.0,0,0,0,False,2022
243,001,1,2,2022-10-26,17:12:55,26759,26762,0,0,13.6,36.8,0,50.4,0,0,0,0,0,0,116327.68,116341.28,0,21.0,0,45.82,10.0,4.58,0,4.0,0,0,0.0,0,0,0,False,2022
244,001,1,2,2022-10-27,18:07:17,26763,26772,0,0,105,74.8,0,179.8,0,0,0,0,0,0,116341.28,116446.28,7.44,21.0,1.56,155.25,10.0,15.55,0,4.0,0,0,0.0,0,0,0,False,2022
245,001,1,2,2022-10-28,20:36:24,26773,26782,0,0,118.5,23,0,141.5,0,0,0,0,0,0,116446.28,116564.78,19.83,21.0,4.17,106.81,10.0,10.69,0,4.0,0,0,0.0,0,0,0,False,2022
246,001,1,2,2022-10-29,21:42:47,26783,26804,0,0,386.7,25.5,0,412.2,0,0,0,0,0,0,116564.78,116951.48,77.69,21.0,16.31,289.26,10.0,28.94,0,4.0,0,0,0.0,0,0,0,False,2022
247,001,1,2,2022-10-30,19:13:39,26805,26830,0,0,394.7,0,0,394.7,0,0,0,0,0,0,116951.48,117346.18,65.7,21.0,13.8,286.55,10.0,28.65,0,4.0,0,0,0.0,0,0,0,False,2022
248,001,1,2,2022-10-31,16:00:13,26831,26864,0,0,141.5,37.2,0,178.7,0,0,0,0,0,0,117346.18,117487.68,2.48,21.0,0.52,159.73,10.0,15.97,0,4.0,0,0,0.0,0,0,0,False,2022
249,001,1,2,2022-11-01,19:27:02,26865,26879,0,0,306.5,72.1,0,378.6,0,0,0,0,0,0,117487.68,117794.18,19.42,21.0,4.08,322.8,10.0,32.3,0,4.0,0,0,0.0,0,0,0,False,2022
250,001,1,2,2022-11-02,17:07:15,26880,26888,0,0,60.3,54.1,0,114.4,0,0,0,0,0,0,117794.18,117854.48,5.79,21.0,1.21,97.64,10.0,9.76,0,4.0,0,0,0.0,0,0,0,False,2022
251,001,1,2,2022-11-03,17:56:34,26889,26905,0,0,105.8,200.7,0,306.5,0,0,0,0,0,0,117854.48,117960.28,57.85,21.0,12.15,215,10.0,21.5,0,4.0,0,0,0.0,0,0,0,False,2022
252,001,1,2,2022-11-04,19:48:54,26906,26922,0,0,115.2,154.7,0,269.9,0,0,0,0,0,0,117960.28,118075.48,8.27,21.0,1.73,236.27,10.0,23.63,0,4.0,0,0,0.0,0,0,0,False,2022
253,001,1,2,2022-11-05,18:57:02,26923,26953,0,0,295.5,190.2,0,485.7,0,0,0,0,0,0,118075.48,118370.98,42.16,21.0,8.84,395.19,10.0,39.51,0,4.0,0,0,0.0,0,0,0,False,2022
254,001,1,2,2022-11-06,19:37:29,26954,26998,0,0,252.14,245.6,0,497.74,0,0,0,0,0,0,118370.98,118623.12,17.97,21.0,3.77,432.72,10.0,43.28,0,4.0,0,0,0.0,0,0,0,False,2022
255,001,1,2,2022-11-07,17:19:11,26999,27014,0,0,53.5,138.1,0,191.6,0,0,0,0,0,0,118623.12,118676.62,4.96,21.0,1.04,168.72,10.0,16.88,0,4.0,0,0,0.0,0,0,0,False,2022
256,001,1,2,2022-11-08,17:39:56,27015,27034,0,0,77.9,202,0,279.9,0,0,0,0,0,0,118676.62,118754.52,4.79,21.0,1.01,249.2,10.0,24.9,0,4.0,0,0,0.0,0,0,0,False,2022
257,001,1,2,2022-11-09,17:10:05,27035,27041,0,0,22.82,44.6,0,67.42,0,0,0,0,0,0,118754.52,118777.34,0.1,21.0,0.02,61.17,10.0,6.13,0,4.0,0,0,0.0,0,0,0,False,2022
258,001,1,2,2022-11-10,17:09:39,27042,27063,0,0,79.8,188.5,0,268.3,0,0,0,0,0,0,118777.34,118857.14,10.33,21.0,2.17,232.55,10.0,23.25,0,4.0,0,0,0.0,0,0,0,False,2022
259,001,1,2,2022-11-11,19:40:02,27064,27069,0,0,60.2,58.4,0,118.6,0,0,0,0,0,0,118857.14,118917.34,2.48,21.0,0.52,105.1,10.0,10.5,0,4.0,0,0,0.0,0,0,0,False,2022
260,001,1,2,2022-11-12,19:34:19,27070,27120,0,0,245.7,405.2,0,650.9,0,0,0,0,0,0,118917.34,119163.04,42.57,21.0,8.93,544.89,10.0,54.51,0,4.0,0,0,0.0,0,0,0,False,2022
261,001,1,2,2022-11-13,18:17:18,27121,27234,0,0,641.1,304.3,0,945.4,0,0,0,0,0,0,119163.04,119804.14,35.54,21.0,7.46,820.45,10.0,81.95,0,4.0,0,0,0.0,0,0,0,False,2022
262,001,1,2,2022-11-14,17:03:59,27235,27250,0,0,30.2,137,0,167.2,0,0,0,0,0,0,119804.14,119834.34,0,21.0,0,152,10.0,15.2,0,4.0,0,0,0.0,0,0,0,False,2022
263,001,1,2,2022-11-15,17:45:40,27251,27265,0,0,38,142.4,0,180.4,0,0,0,0,0,0,119834.34,119872.34,9.5,21.0,2,153.54,10.0,15.36,0,4.0,0,0,0.0,0,0,0,False,2022
264,001,1,2,2022-11-16,16:06:41,27266,27274,0,0,36.4,62.4,0,98.8,0,0,0,0,0,0,119872.34,119908.74,8.77,21.0,1.83,80.18,10.0,8.02,0,4.0,0,0,0.0,0,0,0,False,2022
265,001,1,2,2022-11-17,16:21:19,27275,27294,0,0,73.1,162.3,0,235.4,0,0,0,0,0,0,119908.74,119981.84,3.72,21.0,0.78,209.91,10.0,20.99,0,4.0,0,0,0.0,0,0,0,False,2022
266,001,1,2,2022-11-18,16:51:29,27295,27304,0,0,88,107.5,0,195.5,0,0,0,0,0,0,119981.84,120069.84,16.12,21.0,3.38,159.99,10.0,16.01,0,4.0,0,0,0.0,0,0,0,False,2022
267,001,1,2,2022-11-19,17:17:06,27305,27314,0,0,0,176.8,0,176.8,0,0,0,0,0,0,120069.84,120069.84,0,21.0,0,160.73,10.0,16.07,0,4.0,0,0,0.0,0,0,0,False,2022
268,001,1,2,2022-11-20,19:25:18,27315,27332,0,0,24,362.8,0,386.8,0,0,0,0,0,0,120069.84,120093.84,1.24,21.0,0.26,350.28,10.0,35.02,0,4.0,0,0,0.0,0,0,0,False,2022
269,001,1,2,2022-11-21,15:48:56,27333,27337,0,0,13.9,48.7,0,62.6,0,0,0,0,0,0,120093.84,120107.74,0,21.0,0,56.91,10.0,5.69,0,4.0,0,0,0.0,0,0,0,False,2022
270,001,1,2,2022-11-22,16:25:25,27338,27343,0,0,3.8,53.3,0,57.1,0,0,0,0,0,0,120107.74,120111.54,1.24,21.0,0.26,50.54,10.0,5.06,0,4.0,0,0,0.0,0,0,0,False,2022
271,001,1,2,2022-11-23,15:42:24,27344,27348,0,0,0,37.3,0,37.3,0,0,0,0,0,0,120111.54,120111.54,0,21.0,0,33.92,10.0,3.38,0,4.0,0,0,0.0,0,0,0,False,2022
272,001,1,2,2022-11-24,15:54:07,27349,27356,0,0,5,56,0,61,0,0,0,0,0,0,120111.54,120116.54,0,21.0,0,55.45,10.0,5.55,0,4.0,0,0,0.0,0,0,0,False,2022
273,001,1,2,2022-11-25,18:16:14,27357,27362,0,0,0,80.9,0,80.9,0,0,0,0,0,0,120116.54,120116.54,0,21.0,0,73.55,10.0,7.35,0,4.0,0,0,0.0,0,0,0,False,2022
274,001,1,2,2022-11-26,19:43:23,27363,27392,0,0,224.3,198.7,0,423,0,0,0,0,0,0,120116.54,120340.84,21.08,21.0,4.42,361.38,10.0,36.12,0,4.0,0,0,0.0,0,0,0,False,2022
275,001,1,2,2022-11-27,16:50:01,27393,27422,0,0,256,231.7,0,487.7,0,0,0,0,0,0,120340.84,120596.84,31,21.0,6.5,409.28,10.0,40.92,0,4.0,0,0,0.0,0,0,0,False,2022
276,001,1,2,2022-11-28,16:18:06,27423,27430,0,0,49.5,26.5,0,76,0,0,0,0,0,0,120596.84,120646.34,13.64,21.0,2.86,54.08,10.0,5.42,0,4.0,0,0,0.0,0,0,0,False,2022
277,001,1,2,2022-11-29,16:39:15,27431,27433,0,0,27.2,26.5,0,53.7,0,0,0,0,0,0,120646.34,120673.54,8.26,21.0,1.74,39.73,10.0,3.97,0,4.0,0,0,0.0,0,0,0,False,2022
278,001,1,2,2022-11-30,20:57:53,27434,27450,0,0,136.6,169.6,0,306.2,0,0,0,0,0,0,120673.54,120810.14,32.23,21.0,6.77,242.9,10.0,24.3,0,4.0,0,0,0.0,0,0,0,False,2022
279,001,1,2,2022-12-01,17:53:22,27451,27455,0,0,0,37.3,0,37.3,0,0,0,0,0,0,120810.14,120810.14,7.85,21.0,1.65,25.27,10.0,2.53,0,4.0,0,0,0.0,0,0,0,False,2022
280,001,1,2,2022-12-02,19:10:24,27456,27470,0,0,27.12,131.8,0,158.92,0,0,0,0,0,0,120810.14,120837.26,16.47,21.0,3.45,126.35,10.0,12.65,0,4.0,0,0,0.0,0,0,0,False,2022
281,001,1,2,2022-12-03,19:33:34,27471,27507,0,0,316.3,314.9,0,631.2,0,0,0,0,0,0,120837.26,121153.56,63.24,21.0,13.26,504.28,10.0,50.42,0,4.0,0,0,0.0,0,0,0,False,2022
282,001,1,2,2022-12-04,17:23:32,27508,27535,0,0,213.7,423.4,0,637.1,0,0,0,0,0,0,121153.56,121367.26,73.15,21.0,15.35,498.73,10.0,49.87,0,4.0,0,0,0.0,0,0,0,False,2022
283,001,1,2,2022-12-05,16:26:09,27536,27542,0,0,135.9,49.5,0,185.4,0,0,0,0,0,0,121367.26,121503.16,26.86,21.0,5.64,139,10.0,13.9,0,4.0,0,0,0.0,0,0,0,False,2022
284,001,1,2,2022-12-06,19:05:29,27543,27562,0,0,115.2,197.2,0,312.4,0,0,0,0,0,0,121503.16,121618.36,25.21,21.0,5.29,256.27,10.0,25.63,0,4.0,0,0,0.0,0,0,0,False,2022
285,001,1,2,2022-12-07,16:07:55,27563,27569,0,0,21.9,76.6,0,98.5,0,0,0,0,0,0,121618.36,121640.26,9.5,21.0,2,79.08,10.0,7.92,0,4.0,0,0,0.0,0,0,0,False,2022
286,001,1,2,2022-12-08,17:03:17,27570,27608,0,0,287.2,62.2,0,349.4,0,0,0,0,0,0,121640.26,121927.46,15.29,21.0,3.21,300.8,10.0,30.1,0,4.0,0,0,0.0,0,0,0,False,2022
287,001,1,2,2022-12-09,17:11:07,27609,27638,0,0,307.2,81.6,0,388.8,0,0,0,0,0,0,121927.46,122234.66,6.2,21.0,1.3,346.6,10.0,34.7,0,4.0,0,0,0.0,0,0,0,False,2022
288,001,1,2,2022-12-10,19:05:44,27639,27661,0,0,164.4,262.5,0,426.9,0,0,0,0,0,0,122234.66,122399.06,39.67,21.0,8.33,344.44,10.0,34.46,0,4.0,0,0,0.0,0,0,0,False,2022
289,001,1,2,2022-12-11,18:09:22,27662,27715,0,0,418.7,251.2,0,669.9,0,0,0,0,0,0,122399.06,122817.76,36.78,21.0,7.72,568.54,10.0,56.86,0,4.0,0,0,0.0,0,0,0,False,2022
290,001,1,2,2022-12-12,16:26:59,27716,27733,0,0,131.3,51.3,0,182.6,0,0,0,0,0,0,122817.76,122949.06,13.23,21.0,2.77,151.45,10.0,15.15,0,4.0,0,0,0.0,0,0,0,False,2022
291,001,1,2,2022-12-14,18:25:37,27734,27758,0,0,54,75.8,0,129.8,0,0,0,0,0,0,122949.06,123003.06,9.51,21.0,1.99,107.55,10.0,10.75,0,4.0,0,0,0.0,0,0,0,False,2022
292,001,1,2,2022-12-15,18:23:36,27759,27801,0,0,171.3,130.9,0,302.2,0,0,0,0,0,0,123003.06,123174.36,13.23,21.0,2.77,260.14,10.0,26.06,0,4.0,0,0,0.0,0,0,0,False,2022
293,001,1,2,2022-12-16,20:32:13,27802,27820,0,0,100.6,107.5,0,208.1,0,0,0,0,0,0,123174.36,123274.96,39.26,21.0,8.24,145.99,10.0,14.61,0,4.0,0,0,0.0,0,0,0,False,2022
294,001,1,2,2022-12-17,19:56:15,27821,27886,0,0,478.7,279.2,0,757.9,0,0,0,0,0,0,123274.96,123753.66,55.78,21.0,11.72,627.67,10.0,62.73,0,4.0,0,0,0.0,0,0,0,False,2022
295,001,1,2,2022-12-18,20:06:00,27887,27979,0,0,621.3,249,0,870.3,0,0,0,0,0,0,123753.66,124374.96,43.4,21.0,9.1,743.48,10.0,74.32,0,4.0,0,0,0.0,0,0,0,False,2022
296,001,1,2,2022-12-19,17:23:56,27980,28030,0,0,282.7,120.4,0,403.1,0,0,0,0,0,0,124374.96,124657.66,11.57,21.0,2.43,353.71,10.0,35.39,0,4.0,0,0,0.0,0,0,0,False,2022
297,001,1,2,2022-12-20,17:09:35,28031,28067,0,0,254.8,64.6,0,319.4,0,0,0,0,0,0,124657.66,124912.46,23.97,21.0,5.03,263.99,10.0,26.41,0,4.0,0,0,0.0,0,0,0,False,2022
298,001,1,2,2022-12-21,18:06:49,28068,28105,0,0,194.8,116,0,310.8,0,0,0,0,0,0,124912.46,125107.26,17.36,21.0,3.64,263.45,10.0,26.35,0,4.0,0,0,0.0,0,0,0,False,2022
299,001,1,2,2022-12-22,19:42:33,28106,28128,0,0,208.32,287.9,0,496.22,0,0,0,0,0,0,125107.26,125315.58,51.18,21.0,10.74,394.83,10.0,39.47,0,4.0,0,0,0.0,0,0,0,False,2022
300,001,1,2,2022-12-23,21:22:11,28129,28208,0,0,515.02,251.6,0,766.62,0,0,0,0,0,0,125315.58,125830.6,76.15,21.0,15.97,613.16,10.0,61.34,0,4.0,0,0,0.0,0,0,0,False,2022
301,001,1,2,2022-12-24,17:07:20,28209,28268,0,0,558.2,241.9,0,800.1,0,0,0,0,0,0,125830.6,126388.8,83.8,21.0,17.6,635.17,10.0,63.53,0,4.0,0,0,0.0,0,0,0,False,2022
302,001,1,2,2022-12-25,17:58:48,28269,28310,0,0,475.82,167.5,0,643.32,0,0,0,0,0,0,126388.8,126864.62,48.44,21.0,10.18,531.56,10.0,53.14,0,4.0,0,0,0.0,0,0,0,False,2022
303,001,1,2,2022-12-26,17:37:42,28311,28364,0,0,398.12,297.8,0,695.92,0,0,0,0,0,0,126864.62,127262.74,74.89,21.0,15.73,550.26,10.0,55.04,0,4.0,0,0,0.0,0,0,0,False,2022
304,001,1,2,2022-12-27,17:56:45,28365,28416,0,0,248.2,173.9,0,422.1,0,0,0,0,0,0,127262.74,127510.94,26.04,21.0,5.46,355.1,10.0,35.5,0,4.0,0,0,0.0,0,0,0,False,2022
305,001,1,2,2022-12-28,18:14:55,28417,28434,0,0,106.5,116.8,0,223.3,0,0,0,0,0,0,127510.94,127617.44,31.99,21.0,6.71,167.84,10.0,16.76,0,4.0,0,0,0.0,0,0,0,False,2022
306,001,1,2,2022-12-29,18:05:45,28435,28470,0,0,171.02,137.4,0,308.42,0,0,0,0,0,0,127617.44,127788.46,12.5,21.0,2.62,266.61,10.0,26.69,0,4.0,0,0,0.0,0,0,0,False,2022
307,001,1,2,2022-12-30,17:54:24,28471,28520,0,0,348.6,91.7,0,440.3,0,0,0,0,0,0,127788.46,128137.06,44.63,21.0,9.37,351.14,10.0,35.16,0,4.0,0,0,0.0,0,0,0,False,2022
308,001,1,2,2022-12-31,17:36:46,28521,28572,0,0,388.52,243.6,0,632.12,0,0,0,0,0,0,128137.06,128525.58,61.44,21.0,12.88,507.11,10.0,50.69,0,4.0,0,0,0.0,0,0,0,False,2022
309,001,1,2,2023-01-01,17:23:38,28573,28608,0,0,408,28.4,0,436.4,0,0,0,0,0,0,128525.58,128933.58,26.05,21.0,5.45,368.08,10.0,36.82,0,4.0,0,0,0.0,0,0,0,False,2022
310,001,1,2,2023-01-02,17:24:55,28609,28638,0,0,259.5,335.7,0,595.2,0,0,0,0,0,0,128933.58,129193.08,64.47,21.0,13.53,470.18,10.0,47.02,0,4.0,0,0,0.0,0,0,0,False,2022
311,001,1,2,2023-01-03,17:43:41,28639,28648,0,0,23.6,77.6,0,101.2,0,0,0,0,0,0,129193.08,129216.68,6.2,21.0,1.3,85.18,10.0,8.52,0,4.0,0,0,0.0,0,0,0,False,2022
312,001,1,2,2023-01-04,18:56:27,28649,28704,0,0,382.3,136.9,0,519.2,0,0,0,0,0,0,129216.68,129598.98,72.73,21.0,15.27,392,10.0,39.2,0,4.0,0,0,0.0,0,0,0,False,2022
313,001,1,2,2023-01-05,18:24:15,28705,28749,0,0,297.1,136.1,0,433.2,0,0,0,0,0,0,129598.98,129896.08,65.72,21.0,13.78,321.54,10.0,32.16,0,4.0,0,0,0.0,0,0,0,False,2022
314,001,1,2,2023-01-06,18:57:40,28750,28807,0,0,558.72,230.7,0,789.42,0,0,0,0,0,0,129896.08,130454.8,103.41,21.0,21.71,603.9,10.0,60.4,0,4.0,0,0,0.0,0,0,0,False,2022
315,001,1,2,2023-01-07,19:41:34,28808,28869,0,0,407.72,289.9,0,697.62,0,0,0,0,0,0,130454.8,130862.52,77.79,21.0,16.33,548.62,10.0,54.88,0,4.0,0,0,0.0,0,0,0,False,2022
316,001,1,2,2023-01-08,17:40:27,28870,28925,0,0,535.2,348.7,0,883.9,0,0,0,0,0,0,130862.52,131397.72,124.8,21.0,26.2,666.27,10.0,66.63,0,4.0,0,0,0.0,0,0,0,False,2022
317,001,1,2,2023-01-09,16:32:18,28926,28974,0,0,376.7,155.3,0,532,0,0,0,0,0,0,131397.72,131774.42,7.44,21.0,1.56,475.44,10.0,47.56,0,4.0,0,0,0.0,0,0,0,False,2022
318,001,1,2,2023-01-10,17:07:24,28975,28991,0,0,145.4,83.6,0,229,0,0,0,0,0,0,131774.42,131919.82,18.6,21.0,3.9,187.72,10.0,18.78,0,4.0,0,0,0.0,0,0,0,False,2022
319,001,1,2,2023-01-11,17:20:46,28992,29012,0,0,102.46,232.6,0,335.06,0,0,0,0,0,0,131919.82,132022.28,37.91,21.0,7.95,262.89,10.0,26.31,0,4.0,0,0,0.0,0,0,0,False,2022
320,001,1,2,2023-01-12,18:08:33,29013,29059,0,0,374,162.7,0,536.7,0,0,0,0,0,0,132022.28,132396.28,54.97,21.0,11.53,427.43,10.0,42.77,0,4.0,0,0,0.0,0,0,0,False,2022
321,001,1,2,2023-01-13,18:35:41,29060,29104,0,0,324.12,117.5,0,441.62,0,0,0,0,0,0,132396.28,132720.4,43.66,21.0,9.16,353.45,10.0,35.35,0,4.0,0,0,0.0,0,0,0,False,2022
322,001,1,2,2023-01-14,18:13:56,29105,29154,0,0,295.2,514.4,0,809.6,0,0,0,0,0,0,132720.4,133015.6,78.93,21.0,16.57,649.21,10.0,64.89,0,4.0,0,0,0.0,0,0,0,False,2022
