NUMERO,CODCAJA,VENDEDOR,CODUSU,FECHA,HORA,DESTIC,HASTIC,DESFAC,HASFAC,EFECTIVO,TARJETA,EFECBANCO,TTIC,TFAC,TTICPEN,DESMOV,HASMOV,TENTRADA,TSALIDA,ANSALDO,SALDO,BASEIMP1,IVA1,IMPIVA1,BASEIMP2,IVA2,IMPIVA2,BASEIMP3,IVA3,IMPIVA3,BASEIMP4,IVA4,IMPIVA4,COMENSALES,IMRECUENTO,CONTABILIZ,year_file
1,001,1,2,2021-01-05,19:34:20,6833,6858,0,0,32.5,6.5,0,39,0,0,0,0,0,0,30235.8,30268.3,0,21.0,0,35.43,10.0,3.57,0,4.0,0,0,0.0,0,0,0,False,2021
2,001,1,2,2021-01-06,18:02:19,6859,6909,0,0,89.4,11.6,0,101,0,0,0,0,0,0,30268.3,30357.7,0,21.0,0,91.81,10.0,9.19,0,4.0,0,0,0.0,0,0,0,False,2021
3,001,1,2,2021-01-07,19:10:36,6910,6966,0,0,118.1,0,0,118.1,0,0,0,0,0,0,30357.7,30475.8,0,21.0,0,107.31,10.0,10.79,0,4.0,0,0,0.0,0,0,0,False,2021
4,001,1,2,2021-01-08,17:44:49,6967,7008,0,0,54.2,40.8,0,95,0,0,0,0,0,0,30475.8,30530,0,21.0,0,86.36,10.0,8.64,0,4.0,0,0,0.0,0,0,0,False,2021
5,001,1,2,2021-01-09,18:22:54,7009,7059,0,0,73,8.5,0,81.5,0,0,0,0,0,0,30530,30603,0,21.0,0,74.09,10.0,7.41,0,4.0,0,0,0.0,0,0,0,False,2021
6,001,1,2,2021-01-10,16:46:40,7060,7090,0,0,109,7.5,0,116.5,0,0,0,0,0,0,30603,30712,0,21.0,0,105.91,10.0,10.59,0,4.0,0,0,0.0,0,0,0,False,2021
7,001,1,2,2021-01-11,16:58:45,7091,7116,0,0,94.5,0,0,94.5,0,0,0,0,0,0,30712,30806.5,0,21.0,0,85.91,10.0,8.59,0,4.0,0,0,0.0,0,0,0,False,2021
8,001,1,2,2021-01-12,18:20:31,7117,7156,0,0,160,0,0,160,0,0,0,0,0,0,30806.5,30966.5,0,21.0,0,145.47,10.0,14.53,0,4.0,0,0,0.0,0,0,0,False,2021
9,001,1,2,2021-01-13,16:51:25,7157,7180,0,0,114.1,0,0,114.1,0,0,0,0,0,0,30966.5,31080.6,0,21.0,0,103.7,10.0,10.4,0,4.0,0,0,0.0,0,0,0,False,2021
10,001,1,2,2021-01-15,15:42:44,7181,7198,0,0,73.4,0,0,73.4,0,0,0,0,0,0,31080.6,31154,0,21.0,0,66.75,10.0,6.65,0,4.0,0,0,0.0,0,0,0,False,2021
11,001,1,2,2021-01-16,15:57:42,7199,7229,0,0,80.4,0,0,80.4,0,0,0,0,0,0,31154,31234.4,0,21.0,0,73.08,10.0,7.32,0,4.0,0,0,0.0,0,0,0,False,2021
12,001,1,2,2021-01-17,17:25:42,7230,7263,0,0,120.4,0,0,120.4,0,0,0,0,0,0,31234.4,31354.8,0,21.0,0,109.46,10.0,10.94,0,4.0,0,0,0.0,0,0,0,False,2021
13,001,1,2,2021-01-19,17:14:23,7264,7281,0,0,56.2,0,0,56.2,0,0,0,0,0,0,31354.8,31411,0,21.0,0,51.11,10.0,5.09,0,4.0,0,0,0.0,0,0,0,False,2021
14,001,1,2,2021-01-20,19:05:08,7282,7306,0,0,66.6,0,0,66.6,0,0,0,0,0,0,31411,31477.6,0,21.0,0,60.54,10.0,6.06,0,4.0,0,0,0.0,0,0,0,False,2021
15,001,1,2,2021-01-21,18:02:52,7307,7329,0,0,75.7,0,0,75.7,0,0,0,0,0,0,31477.6,31553.3,0,21.0,0,68.84,10.0,6.86,0,4.0,0,0,0.0,0,0,0,False,2021
16,001,1,2,2021-01-22,20:26:10,7330,7353,0,0,61,0,0,61,0,0,0,0,0,0,31553.3,31614.3,0,21.0,0,55.48,10.0,5.52,0,4.0,0,0,0.0,0,0,0,False,2021
17,001,1,2,2021-01-23,18:33:26,7354,7388,0,0,145.7,0,0,145.7,0,0,0,0,0,0,31614.3,31760,0,21.0,0,132.46,10.0,13.24,0,4.0,0,0,0.0,0,0,0,False,2021
18,001,1,2,2021-01-24,17:18:40,7389,7419,0,0,125,0,0,125,0,0,0,0,0,0,31760,31885,0,21.0,0,113.65,10.0,11.35,0,4.0,0,0,0.0,0,0,0,False,2021
19,001,1,2,2021-01-25,14:50:37,7420,7429,0,0,31,0,0,31,0,0,0,0,0,0,31885,31916,0,21.0,0,28.18,10.0,2.82,0,4.0,0,0,0.0,0,0,0,False,2021
20,001,1,2,2021-01-25,14:54:12,7430,7430,0,0,1,0,0,1,0,0,0,0,0,0,31916,31917,0,21.0,0,0.91,10.0,0.09,0,4.0,0,0,0.0,0,0,0,False,2021
21,001,1,2,2021-01-26,17:01:31,7431,7442,0,0,41.5,0,0,41.5,0,0,0,0,0,0,31917,31958.5,0,21.0,0,37.75,10.0,3.75,0,4.0,0,0,0.0,0,0,0,False,2021
22,001,1,2,2021-01-27,16:45:21,7443,7473,0,0,91.3,0,0,91.3,0,0,0,0,0,0,31958.5,32049.8,0,21.0,0,83.02,10.0,8.28,0,4.0,0,0,0.0,0,0,0,False,2021
23,001,1,2,2021-01-28,18:26:37,7474,7489,0,0,36.5,0,0,36.5,0,0,0,0,0,0,32049.8,32086.3,0,21.0,0,33.19,10.0,3.31,0,4.0,0,0,0.0,0,0,0,False,2021
24,001,1,2,2021-01-29,16:34:14,7490,7510,0,0,52.5,0,0,52.5,0,0,0,0,0,0,32086.3,32138.8,0,21.0,0,47.75,10.0,4.75,0,4.0,0,0,0.0,0,0,0,False,2021
25,001,1,2,2021-01-30,15:26:42,7511,7540,0,0,118.9,0,0,118.9,0,0,0,0,0,0,32138.8,32257.7,0,21.0,0,108.08,10.0,10.82,0,4.0,0,0,0.0,0,0,0,False,2021
26,001,1,2,2021-02-02,16:27:01,7541,7558,0,0,49.5,0,0,49.5,0,0,0,0,0,0,32257.7,32307.2,0,21.0,0,45,10.0,4.5,0,4.0,0,0,0.0,0,0,0,False,2021
27,001,1,2,2021-02-03,14:56:33,7559,7574,0,0,58.9,0,0,58.9,0,0,0,0,0,0,32307.2,32366.1,0,21.0,0,53.56,10.0,5.34,0,4.0,0,0,0.0,0,0,0,False,2021
28,001,1,2,2021-02-04,14:44:40,7575,7590,0,0,72.2,0,0,72.2,0,0,0,0,0,0,32366.1,32438.3,0,21.0,0,65.63,10.0,6.57,0,4.0,0,0,0.0,0,0,0,False,2021
29,001,1,2,2021-02-05,17:21:17,7591,7612,0,0,55.5,0,0,55.5,0,0,0,0,0,0,32438.3,32493.8,0,21.0,0,50.49,10.0,5.01,0,4.0,0,0,0.0,0,0,0,False,2021
30,001,1,2,2021-02-06,15:50:14,7613,7638,0,0,75.8,0,0,75.8,0,0,0,0,0,0,32493.8,32569.6,0,21.0,0,68.89,10.0,6.91,0,4.0,0,0,0.0,0,0,0,False,2021
31,001,1,2,2021-02-08,15:06:11,7639,7651,0,0,36,0,0,36,0,0,0,0,0,0,32569.6,32605.6,0,21.0,0,32.75,10.0,3.25,0,4.0,0,0,0.0,0,0,0,False,2021
32,001,1,2,2021-02-10,17:43:49,7652,7659,0,0,21,0,0,21,0,0,0,0,0,0,32605.6,32626.6,0,21.0,0,19.11,10.0,1.89,0,4.0,0,0,0.0,0,0,0,False,2021
33,001,1,2,2021-02-11,17:09:17,7660,7680,0,0,92.5,0,0,92.5,0,0,0,0,0,0,32626.6,32719.1,0,21.0,0,84.07,10.0,8.43,0,4.0,0,0,0.0,0,0,0,False,2021
34,001,1,2,2021-02-12,17:11:06,7681,7702,0,0,71,0,0,71,0,0,0,0,0,0,32719.1,32790.1,0,21.0,0,64.56,10.0,6.44,0,4.0,0,0,0.0,0,0,0,False,2021
35,001,1,2,2021-02-13,17:18:21,7703,7738,0,0,119.2,0,0,119.2,0,0,0,0,0,0,32790.1,32909.3,0,21.0,0,108.38,10.0,10.82,0,4.0,0,0,0.0,0,0,0,False,2021
36,001,1,2,2021-02-14,16:00:11,7739,7777,0,0,194.4,0,0,194.4,0,0,0,0,0,0,32909.3,33103.7,0,21.0,0,176.74,10.0,17.66,0,4.0,0,0,0.0,0,0,0,False,2021
37,001,1,2,2021-02-15,13:54:30,7778,7787,0,0,23.5,0,0,23.5,0,0,0,0,0,0,33103.7,33127.2,0,21.0,0,21.38,10.0,2.12,0,4.0,0,0,0.0,0,0,0,False,2021
38,001,1,2,2021-02-16,16:58:55,7788,7806,0,0,91.6,0,0,91.6,0,0,0,0,0,0,33127.2,33218.8,0,21.0,0,83.28,10.0,8.32,0,4.0,0,0,0.0,0,0,0,False,2021
39,001,1,2,2021-02-17,16:34:12,7807,7827,0,0,54.9,0,0,54.9,0,0,0,0,0,0,33218.8,33273.7,0,21.0,0,49.9,10.0,5,0,4.0,0,0,0.0,0,0,0,False,2021
40,001,1,2,2021-02-18,16:15:08,7828,7842,0,0,51,0,0,51,0,0,0,0,0,0,33273.7,33324.7,0,21.0,0,46.38,10.0,4.62,0,4.0,0,0,0.0,0,0,0,False,2021
41,001,1,2,2021-02-19,18:09:12,7843,7870,0,0,109.5,0,0,109.5,0,0,0,0,0,0,33324.7,33434.2,0,21.0,0,99.55,10.0,9.95,0,4.0,0,0,0.0,0,0,0,False,2021
42,001,1,2,2021-02-20,16:24:08,7871,7893,0,0,90,0,0,90,0,0,0,0,0,0,33434.2,33524.2,0,21.0,0,81.82,10.0,8.18,0,4.0,0,0,0.0,0,0,0,False,2021
43,001,1,2,2021-02-21,16:50:19,7894,7931,0,0,186.9,0,0,186.9,0,0,0,0,0,0,33524.2,33711.1,0,21.0,0,169.92,10.0,16.98,0,4.0,0,0,0.0,0,0,0,False,2021
44,001,1,2,2021-02-22,15:46:07,7932,7949,0,0,65,0,0,65,0,0,0,0,0,0,33711.1,33776.1,0,21.0,0,59.11,10.0,5.89,0,4.0,0,0,0.0,0,0,0,False,2021
45,001,1,2,2021-02-23,15:49:03,7950,7961,0,0,63.2,0,0,63.2,0,0,0,0,0,0,33776.1,33839.3,0,21.0,0,57.46,10.0,5.74,0,4.0,0,0,0.0,0,0,0,False,2021
46,001,1,2,2021-02-24,16:31:11,7962,7974,0,0,42.5,13,0,55.5,0,0,0,0,0,0,33839.3,33881.8,0,21.0,0,50.45,10.0,5.05,0,4.0,0,0,0.0,0,0,0,False,2021
47,001,1,2,2021-02-25,16:56:13,7975,8001,0,0,96.4,0,0,96.4,0,0,0,0,0,0,33881.8,33978.2,0,21.0,0,87.66,10.0,8.74,0,4.0,0,0,0.0,0,0,0,False,2021
48,001,1,2,2021-02-26,16:47:05,8002,8019,0,0,71.4,0,0,71.4,0,0,0,0,0,0,33978.2,34049.6,0,21.0,0,64.92,10.0,6.48,0,4.0,0,0,0.0,0,0,0,False,2021
49,001,1,2,2021-02-27,17:06:43,8020,8052,0,0,121.4,0,0,121.4,0,0,0,0,0,0,34049.6,34171,0,21.0,0,110.36,10.0,11.04,0,4.0,0,0,0.0,0,0,0,False,2021
50,001,1,2,2021-02-28,15:59:30,8053,8081,0,0,139.7,0,0,139.7,0,0,0,0,0,0,34171,34310.7,0,21.0,0,127,10.0,12.7,0,4.0,0,0,0.0,0,0,0,False,2021
51,001,1,2,2021-03-01,13:35:37,8082,8093,0,0,31,0,0,31,0,0,0,0,0,0,34310.7,34341.7,0,21.0,0,28.2,10.0,2.8,0,4.0,0,0,0.0,0,0,0,False,2021
52,001,1,2,2021-03-02,18:58:35,8094,8102,0,0,31,0,0,31,0,0,0,0,0,0,34341.7,34372.7,0,21.0,0,28.18,10.0,2.82,0,4.0,0,0,0.0,0,0,0,False,2021
53,001,1,2,2021-03-03,19:41:39,8103,8124,0,0,134.5,0,0,134.5,0,0,0,0,0,0,34372.7,34507.2,0,21.0,0,122.25,10.0,12.25,0,4.0,0,0,0.0,0,0,0,False,2021
54,001,1,2,2021-03-04,18:34:47,8125,8148,0,0,79.5,13.5,0,93,0,0,0,0,0,0,34507.2,34586.7,0,21.0,0,84.51,10.0,8.49,0,4.0,0,0,0.0,0,0,0,False,2021
55,001,1,2,2021-03-05,19:30:39,8149,8179,0,0,156.5,20,0,176.5,0,0,0,0,0,0,34586.7,34743.2,0,21.0,0,160.44,10.0,16.06,0,4.0,0,0,0.0,0,0,0,False,2021
56,001,1,2,2021-03-06,19:06:04,8180,8232,0,0,397.6,0,0,397.6,0,0,0,0,0,0,34743.2,35140.8,0,21.0,0,361.45,10.0,36.15,0,4.0,0,0,0.0,0,0,0,False,2021
57,001,1,2,2021-03-07,20:51:25,8233,8300,0,0,372.8,0,0,372.8,0,0,0,0,0,0,35140.8,35513.6,0,21.0,0,338.92,10.0,33.88,0,4.0,0,0,0.0,0,0,0,False,2021
58,001,1,2,2021-03-08,17:05:53,8301,8322,0,0,60.4,0,0,60.4,0,0,0,0,0,0,35513.6,35574,0,21.0,0,54.88,10.0,5.52,0,4.0,0,0,0.0,0,0,0,False,2021
59,001,1,2,2021-03-09,23:28:41,8323,8343,0,0,72.4,0,0,72.4,0,0,0,0,0,0,35574,35646.4,0,21.0,0,65.82,10.0,6.58,0,4.0,0,0,0.0,0,0,0,False,2021
60,001,1,2,2021-03-10,11:10:55,8344,8344,0,0,110,0,0,110,0,0,0,0,0,0,35646.4,35756.4,0,21.0,0,100,10.0,10,0,4.0,0,0,0.0,0,0,0,False,2021
61,001,1,2,2021-03-10,18:34:26,8345,8365,0,0,110.4,0,0,110.4,0,0,0,0,0,0,35756.4,35866.8,0,21.0,0,100.37,10.0,10.03,0,4.0,0,0,0.0,0,0,0,False,2021
62,001,1,2,2021-03-11,16:19:23,8366,8388,0,0,79.7,0,0,79.7,0,0,0,0,0,0,35866.8,35946.5,0,21.0,0,72.47,10.0,7.23,0,4.0,0,0,0.0,0,0,0,False,2021
63,001,1,2,2021-03-12,20:01:49,8389,8411,0,0,75.1,8,0,83.1,0,0,0,0,0,0,35946.5,36021.6,0,21.0,0,75.56,10.0,7.54,0,4.0,0,0,0.0,0,0,0,False,2021
64,001,1,2,2021-03-13,21:44:21,8412,8448,0,0,59.6,0,0,59.6,0,0,0,0,0,0,36021.6,36081.2,0,21.0,0,54.16,10.0,5.44,0,4.0,0,0,0.0,0,0,0,False,2021
65,001,1,2,2021-03-14,18:49:00,8449,8480,0,0,149.1,0,0,149.1,0,0,0,0,0,0,36081.2,36230.3,0,21.0,0,135.52,10.0,13.58,0,4.0,0,0,0.0,0,0,0,False,2021
66,001,1,2,2021-03-15,19:50:58,8481,8505,0,0,79,0,0,79,0,0,0,0,0,0,36230.3,36309.3,0,21.0,0,71.79,10.0,7.21,0,4.0,0,0,0.0,0,0,0,False,2021
67,001,1,2,2021-03-16,20:21:41,8506,8525,0,0,48.6,0,0,48.6,0,0,0,0,0,0,36309.3,36357.9,0,21.0,0,44.19,10.0,4.41,0,4.0,0,0,0.0,0,0,0,False,2021
68,001,1,2,2021-03-17,19:25:12,8526,8536,0,0,29.5,10,0,39.5,0,0,0,0,0,0,36357.9,36387.4,0,21.0,0,35.92,10.0,3.58,0,4.0,0,0,0.0,0,0,0,False,2021
69,001,1,2,2021-03-18,18:01:12,8537,8551,0,0,41.5,0,0,41.5,0,0,0,0,0,0,36387.4,36428.9,0,21.0,0,37.74,10.0,3.76,0,4.0,0,0,0.0,0,0,0,False,2021
70,001,1,2,2021-03-19,20:46:48,8552,8570,0,0,66.9,0,0,66.9,0,0,0,0,0,0,36428.9,36495.8,0,21.0,0,60.83,10.0,6.07,0,4.0,0,0,0.0,0,0,0,False,2021
71,001,1,2,2021-03-20,20:06:40,8571,8590,0,0,41.7,0,0,41.7,0,0,0,0,0,0,36495.8,36537.5,0,21.0,0,37.91,10.0,3.79,0,4.0,0,0,0.0,0,0,0,False,2021
72,001,1,2,2021-03-21,18:53:44,8591,8632,0,0,284.6,0,0,284.6,0,0,0,0,0,0,36537.5,36822.1,0,21.0,0,258.73,10.0,25.87,0,4.0,0,0,0.0,0,0,0,False,2021
73,001,1,2,2021-03-22,17:53:42,8633,8657,0,0,68.1,0,0,68.1,0,0,0,0,0,0,36822.1,36890.2,0,21.0,0,61.91,10.0,6.19,0,4.0,0,0,0.0,0,0,0,False,2021
74,001,1,2,2021-03-23,18:30:59,8658,8676,0,0,44.6,0,0,44.6,0,0,0,0,0,0,36890.2,36934.8,0,21.0,0,40.56,10.0,4.04,0,4.0,0,0,0.0,0,0,0,False,2021
75,001,1,2,2021-03-24,20:13:46,8677,8698,0,0,56.2,10,0,66.2,0,0,0,0,0,0,36934.8,36991,0,21.0,0,60.19,10.0,6.01,0,4.0,0,0,0.0,0,0,0,False,2021
76,001,1,2,2021-03-25,21:05:45,8699,8727,0,0,91.5,0,0,91.5,0,0,0,0,0,0,36991,37082.5,0,21.0,0,83.17,10.0,8.33,0,4.0,0,0,0.0,0,0,0,False,2021
77,001,1,2,2021-03-26,23:06:16,8728,8759,0,0,98,0,0,98,0,0,0,0,0,0,37082.5,37180.5,0,21.0,0,89.11,10.0,8.89,0,4.0,0,0,0.0,0,0,0,False,2021
78,001,1,2,2021-03-27,21:36:15,8760,8781,0,0,61.9,0,0,61.9,0,0,0,0,0,0,37180.5,37242.4,0,21.0,0,56.29,10.0,5.61,0,4.0,0,0,0.0,0,0,0,False,2021
79,001,1,2,2021-03-28,22:25:27,8782,8830,0,0,311,0,0,311,0,0,0,0,0,0,37242.4,37553.4,0,21.0,0,282.72,10.0,28.28,0,4.0,0,0,0.0,0,0,0,False,2021
80,001,1,2,2021-03-29,19:47:47,8831,8870,0,0,145,0,0,145,0,0,0,0,0,0,37553.4,37698.4,0,21.0,0,131.83,10.0,13.17,0,4.0,0,0,0.0,0,0,0,False,2021
81,001,1,2,2021-03-30,21:33:29,8871,8896,0,0,98.5,0,0,98.5,0,0,0,0,0,0,37698.4,37796.9,0,21.0,0,89.57,10.0,8.93,0,4.0,0,0,0.0,0,0,0,False,2021
82,001,1,2,2021-03-31,21:18:18,8897,8924,0,0,76.6,0,0,76.6,0,0,0,0,0,0,37796.9,37873.5,0,21.0,0,69.64,10.0,6.96,0,4.0,0,0,0.0,0,0,0,False,2021
83,001,1,2,2021-04-02,11:06:14,8925,8949,0,0,71.1,0,0,71.1,0,0,0,0,0,0,37873.5,37944.6,0,21.0,0,64.67,10.0,6.43,0,4.0,0,0,0.0,0,0,0,False,2021
84,001,1,2,2021-04-02,19:05:31,8950,8967,0,0,64.4,0,0,64.4,0,0,0,0,0,0,37944.6,38009,0,21.0,0,58.56,10.0,5.84,0,4.0,0,0,0.0,0,0,0,False,2021
85,001,1,2,2021-04-03,22:49:26,8968,9000,0,0,109.1,0,0,109.1,0,0,0,0,0,0,38009,38118.1,0,21.0,0,99.22,10.0,9.88,0,4.0,0,0,0.0,0,0,0,False,2021
86,001,1,2,2021-04-04,21:09:16,9001,9057,0,0,540,0,0,540,0,0,0,0,0,0,38118.1,38658.1,0,21.0,0,490.95,10.0,49.05,0,4.0,0,0,0.0,0,0,0,False,2021
87,001,1,2,2021-04-05,18:17:06,9058,9090,0,0,114.4,0,0,114.4,0,0,0,0,0,0,38658.1,38772.5,0,21.0,0,104.04,10.0,10.36,0,4.0,0,0,0.0,0,0,0,False,2021
88,001,1,2,2021-04-06,18:24:33,9091,9096,0,0,20.5,0,0,20.5,0,0,0,0,0,0,38772.5,38793,0,21.0,0,18.65,10.0,1.85,0,4.0,0,0,0.0,0,0,0,False,2021
89,001,1,2,2021-04-07,19:50:44,9097,9116,0,0,48.3,0,0,48.3,0,0,0,0,0,0,38793,38841.3,0,21.0,0,43.93,10.0,4.37,0,4.0,0,0,0.0,0,0,0,False,2021
90,001,1,2,2021-04-08,23:03:05,9117,9146,0,0,115.6,0,0,115.6,0,0,0,0,0,0,38841.3,38956.9,0,21.0,0,105.11,10.0,10.49,0,4.0,0,0,0.0,0,0,0,False,2021
91,001,1,2,2021-04-09,20:07:43,9147,9176,0,0,107.1,0,0,107.1,0,0,0,0,0,0,38956.9,39064,0,21.0,0,97.39,10.0,9.71,0,4.0,0,0,0.0,0,0,0,False,2021
92,001,1,2,2021-04-10,18:14:31,9177,9209,0,0,120.8,61,0,181.8,0,0,0,0,0,0,39064,39184.8,0,21.0,0,165.27,10.0,16.53,0,4.0,0,0,0.0,0,0,0,False,2021
93,001,1,2,2021-04-11,21:55:01,9210,9272,0,0,488.6,0,0,488.6,0,0,0,0,0,0,39184.8,39673.4,0,21.0,0,444.18,10.0,44.42,0,4.0,0,0,0.0,0,0,0,False,2021
94,001,1,2,2021-04-13,21:54:23,9273,9307,0,0,99.4,0,0,99.4,0,0,0,0,0,0,39673.4,39772.8,0,21.0,0,90.36,10.0,9.04,0,4.0,0,0,0.0,0,0,0,False,2021
95,001,1,2,2021-04-14,20:17:51,9308,9332,0,0,90.5,0,0,90.5,0,0,0,0,0,0,39772.8,39863.3,0,21.0,0,82.29,10.0,8.21,0,4.0,0,0,0.0,0,0,0,False,2021
96,001,1,2,2021-04-15,21:36:10,9333,9375,0,0,155.3,0,0,155.3,0,0,0,0,0,0,39863.3,40018.6,0,21.0,0,141.21,10.0,14.09,0,4.0,0,0,0.0,0,0,0,False,2021
97,001,1,2,2021-04-16,21:04:13,9376,9411,0,0,127.5,0,0,127.5,0,0,0,0,0,0,40018.6,40146.1,0,21.0,0,115.95,10.0,11.55,0,4.0,0,0,0.0,0,0,0,False,2021
98,001,1,2,2021-04-17,21:26:49,9412,9441,0,0,105,0,0,105,0,0,0,0,0,0,40146.1,40251.1,0.83,21.0,0.17,94.56,10.0,9.44,0,4.0,0,0,0.0,0,0,0,False,2021
99,001,1,2,2021-04-18,22:07:36,9442,9506,0,0,409.3,0,0,409.3,0,0,0,0,0,0,40251.1,40660.4,0,21.0,0,372.09,10.0,37.21,0,4.0,0,0,0.0,0,0,0,False,2021
100,001,1,2,2021-04-19,17:08:10,9507,9535,0,0,110.7,0,0,110.7,0,0,0,0,0,0,40660.4,40771.1,0,21.0,0,100.67,10.0,10.03,0,4.0,0,0,0.0,0,0,0,False,2021
101,001,1,2,2021-04-20,19:45:36,9536,9559,0,0,59.5,12,0,71.5,0,0,0,0,0,0,40771.1,40830.6,0,21.0,0,65.02,10.0,6.48,0,4.0,0,0,0.0,0,0,0,False,2021
102,001,1,2,2021-04-21,23:35:43,9560,9588,0,0,104.4,7.4,0,111.8,0,0,0,0,0,0,40830.6,40935,0,21.0,0,101.65,10.0,10.15,0,4.0,0,0,0.0,0,0,0,False,2021
103,001,1,2,2021-04-22,20:08:52,9589,9614,0,0,90.6,0,0,90.6,0,0,0,0,0,0,40935,41025.6,0,21.0,0,82.39,10.0,8.21,0,4.0,0,0,0.0,0,0,0,False,2021
104,001,1,2,2021-04-23,22:40:47,9615,9632,0,0,55.2,0,0,55.2,0,0,0,0,0,0,41025.6,41080.8,0,21.0,0,50.19,10.0,5.01,0,4.0,0,0,0.0,0,0,0,False,2021
105,001,1,2,2021-04-25,21:14:27,9633,9700,0,0,400.6,0,0,400.6,0,0,0,0,0,0,41080.8,41481.4,0,21.0,0,364.2,10.0,36.4,0,4.0,0,0,0.0,0,0,0,False,2021
106,001,1,2,2021-04-26,17:25:36,9701,9733,0,0,151.8,0,0,151.8,0,0,0,0,0,0,41481.4,41633.2,0,21.0,0,138,10.0,13.8,0,4.0,0,0,0.0,0,0,0,False,2021
107,001,1,2,2021-04-28,20:39:45,9734,9754,0,0,75.3,0,0,75.3,0,0,0,0,0,0,41633.2,41708.5,0,21.0,0,68.48,10.0,6.82,0,4.0,0,0,0.0,0,0,0,False,2021
108,001,1,2,2021-04-29,23:37:12,9755,9772,0,0,50.4,0,0,50.4,0,0,0,0,0,0,41708.5,41758.9,0,21.0,0,45.83,10.0,4.57,0,4.0,0,0,0.0,0,0,0,False,2021
109,001,1,2,2021-05-01,00:21:06,9773,9786,0,0,37.9,0,0,37.9,0,0,0,0,0,0,41758.9,41796.8,0,21.0,0,34.46,10.0,3.44,0,4.0,0,0,0.0,0,0,0,False,2021
110,001,1,2,2021-05-01,22:36:20,9787,9792,0,0,25,0,0,25,0,0,0,0,0,0,41796.8,41821.8,0,21.0,0,22.74,10.0,2.26,0,4.0,0,0,0.0,0,0,0,False,2021
111,001,1,2,2021-05-02,20:03:22,9793,9799,0,0,45.5,0,0,45.5,0,0,0,0,0,0,41821.8,41867.3,0,21.0,0,41.36,10.0,4.14,0,4.0,0,0,0.0,0,0,0,False,2021
112,001,1,2,2021-05-03,18:46:10,9800,9809,0,0,44.5,0,0,44.5,0,0,0,0,0,0,41867.3,41911.8,0,21.0,0,40.47,10.0,4.03,0,4.0,0,0,0.0,0,0,0,False,2021
113,001,1,2,2021-05-05,23:19:15,9810,9847,0,0,160.9,0,0,160.9,0,0,0,0,0,0,41911.8,42072.7,0,21.0,0,146.27,10.0,14.63,0,4.0,0,0,0.0,0,0,0,False,2021
114,001,1,2,2021-05-05,23:35:31,9848,9848,0,0,1,0,0,1,0,0,0,0,0,0,42072.7,42073.7,0,21.0,0,0.91,10.0,0.09,0,4.0,0,0,0.0,0,0,0,False,2021
115,001,1,2,2021-05-06,23:51:12,9849,9873,0,0,118.4,0,0,118.4,0,0,0,0,0,0,42073.7,42192.1,0,21.0,0,107.64,10.0,10.76,0,4.0,0,0,0.0,0,0,0,False,2021
116,001,1,2,2021-05-08,00:09:40,9874,9900,0,0,96.2,0,0,96.2,0,0,0,0,0,0,42192.1,42288.3,0,21.0,0,87.49,10.0,8.71,0,4.0,0,0,0.0,0,0,0,False,2021
117,001,1,2,2021-05-08,23:34:33,9901,9916,0,0,103,0,0,103,0,0,0,0,0,0,42288.3,42391.3,0,21.0,0,93.63,10.0,9.37,0,4.0,0,0,0.0,0,0,0,False,2021
118,001,1,2,2021-05-10,19:50:32,9917,9964,0,0,437.7,0,0,437.7,0,0,0,0,0,0,42391.3,42829,0,21.0,0,397.91,10.0,39.79,0,4.0,0,0,0.0,0,0,0,False,2021
119,001,1,2,2021-05-12,23:55:29,9965,9999,0,0,170.5,0,0,170.5,0,0,0,0,0,0,42829,42999.5,0,21.0,0,155.02,10.0,15.48,0,4.0,0,0,0.0,0,0,0,False,2021
120,001,1,2,2021-05-13,21:50:49,10000,10020,0,0,102.7,0,0,102.7,0,0,0,0,0,0,42999.5,43102.2,0,21.0,0,93.38,10.0,9.32,0,4.0,0,0,0.0,0,0,0,False,2021
121,001,1,2,2021-05-15,00:27:13,10021,10040,0,0,108.7,0,0,108.7,0,0,0,0,0,0,43102.2,43210.9,0,21.0,0,98.81,10.0,9.89,0,4.0,0,0,0.0,0,0,0,False,2021
122,001,1,2,2021-05-16,01:09:38,10041,10052,0,0,51.5,0,0,51.5,0,0,0,0,0,0,43210.9,43262.4,0,21.0,0,46.83,10.0,4.67,0,4.0,0,0,0.0,0,0,0,False,2021
123,001,1,2,2021-05-16,13:10:08,10053,10069,0,0,154.9,0,0,154.9,0,0,0,0,0,0,43262.4,43417.3,0,21.0,0,140.83,10.0,14.07,0,4.0,0,0,0.0,0,0,0,False,2021
124,001,1,2,2021-05-17,00:12:30,10070,10094,0,0,213,0,0,213,0,0,0,0,0,0,43417.3,43630.3,0,21.0,0,193.68,10.0,19.32,0,4.0,0,0,0.0,0,0,0,False,2021
125,001,1,2,2021-05-18,15:17:22,10095,10103,0,0,29,0,0,29,0,0,0,0,0,0,43630.3,43659.3,0,21.0,0,26.36,10.0,2.64,0,4.0,0,0,0.0,0,0,0,False,2021
126,001,1,2,2021-05-19,22:43:40,10104,10130,0,0,154.9,0,0,154.9,0,0,0,0,0,0,43659.3,43814.2,0,21.0,0,140.82,10.0,14.08,0,4.0,0,0,0.0,0,0,0,False,2021
127,001,1,2,2021-05-20,22:14:28,10131,10156,0,0,147,0,0,147,0,0,0,0,0,0,43814.2,43961.2,0,21.0,0,133.63,10.0,13.37,0,4.0,0,0,0.0,0,0,0,False,2021
128,001,1,2,2021-05-21,23:28:03,10157,10207,0,0,179.2,0,0,179.2,0,0,0,0,0,0,43961.2,44140.4,0,21.0,0,162.87,10.0,16.33,0,4.0,0,0,0.0,0,0,0,False,2021
129,001,1,2,2021-05-23,00:18:13,10208,10248,0,0,196.5,0,0,196.5,0,0,0,0,0,0,44140.4,44336.9,0,21.0,0,178.64,10.0,17.86,0,4.0,0,0,0.0,0,0,0,False,2021
130,001,1,2,2021-05-23,19:53:24,10249,10283,0,0,302,0,0,302,0,0,0,0,0,0,44336.9,44638.9,0,21.0,0,274.57,10.0,27.43,0,4.0,0,0,0.0,0,0,0,False,2021
131,001,1,2,2021-05-24,18:59:27,10284,10296,0,0,78.2,0,0,78.2,0,0,0,0,0,0,44638.9,44717.1,0,21.0,0,71.08,10.0,7.12,0,4.0,0,0,0.0,0,0,0,False,2021
132,001,1,2,2021-05-26,21:08:10,10297,10329,0,0,134.5,0,0,134.5,0,0,0,0,0,0,44717.1,44851.6,0,21.0,0,122.28,10.0,12.22,0,4.0,0,0,0.0,0,0,0,False,2021
133,001,1,2,2021-05-27,23:13:46,10330,10371,0,0,145.2,0,0,145.2,0,0,0,0,0,0,44851.6,44996.8,0,21.0,0,132.02,10.0,13.18,0,4.0,0,0,0.0,0,0,0,False,2021
134,001,1,2,2021-05-28,23:51:50,10372,10408,0,0,114.2,0,0,114.2,0,0,0,0,0,0,44996.8,45111,0,21.0,0,103.85,10.0,10.35,0,4.0,0,0,0.0,0,0,0,False,2021
135,001,1,2,2021-05-30,00:35:58,10409,10429,0,0,103.2,0,0,103.2,0,0,0,0,0,0,45111,45214.2,0,21.0,0,93.83,10.0,9.37,0,4.0,0,0,0.0,0,0,0,False,2021
136,001,1,2,2021-05-30,23:49:17,10430,10479,0,0,498.2,0,0,498.2,0,0,0,0,0,0,45214.2,45712.4,0,21.0,0,452.9,10.0,45.3,0,4.0,0,0,0.0,0,0,0,False,2021
137,001,1,2,2021-05-31,20:04:54,10480,10517,0,0,173.5,0,0,173.5,0,0,0,0,0,0,45712.4,45885.9,0,21.0,0,157.74,10.0,15.76,0,4.0,0,0,0.0,0,0,0,False,2021
138,001,1,2,2021-06-02,21:24:51,10518,10541,0,0,81,18,0,99,0,0,0,0,0,0,45885.9,45966.9,0,21.0,0,90.01,10.0,8.99,0,4.0,0,0,0.0,0,0,0,False,2021
139,001,1,2,2021-06-03,23:40:05,10542,10572,0,0,112.6,0,0,112.6,0,0,0,0,0,0,45966.9,46079.5,0,21.0,0,102.38,10.0,10.22,0,4.0,0,0,0.0,0,0,0,False,2021
140,001,1,2,2021-06-05,00:16:55,10573,10606,0,0,151.5,0,0,151.5,0,0,0,0,0,0,46079.5,46231,0,21.0,0,137.73,10.0,13.77,0,4.0,0,0,0.0,0,0,0,False,2021
141,001,1,2,2021-06-06,12:12:04,10607,10625,0,0,116.7,0,0,116.7,0,0,0,0,0,0,46231,46347.7,0,21.0,0,106.09,10.0,10.61,0,4.0,0,0,0.0,0,0,0,False,2021
142,001,1,2,2021-06-06,19:59:02,10626,10655,0,0,240.9,0,0,240.9,0,0,0,0,0,0,46347.7,46588.6,0,21.0,0,219.03,10.0,21.87,0,4.0,0,0,0.0,0,0,0,False,2021
143,001,1,2,2021-06-07,21:06:50,10656,10675,0,0,117.5,0,0,117.5,0,0,0,0,0,0,46588.6,46706.1,0,21.0,0,106.84,10.0,10.66,0,4.0,0,0,0.0,0,0,0,False,2021
144,001,1,2,2021-06-09,22:42:10,10676,10705,0,0,173.1,0,0,173.1,0,0,0,0,0,0,46706.1,46879.2,0,21.0,0,157.4,10.0,15.7,0,4.0,0,0,0.0,0,0,0,False,2021
145,001,1,2,2021-06-10,21:59:13,10706,10730,0,0,82.5,0,0,82.5,0,0,0,0,0,0,46879.2,46961.7,0,21.0,0,75,10.0,7.5,0,4.0,0,0,0.0,0,0,0,False,2021
146,001,1,2,2021-06-11,23:54:31,10731,10756,0,0,104.2,0,0,104.2,0,0,0,0,0,0,46961.7,47065.9,0,21.0,0,94.75,10.0,9.45,0,4.0,0,0,0.0,0,0,0,False,2021
147,001,1,2,2021-06-12,20:55:18,10757,10775,0,0,79.7,0,0,79.7,0,0,0,0,0,0,47065.9,47145.6,0,21.0,0,72.47,10.0,7.23,0,4.0,0,0,0.0,0,0,0,False,2021
148,001,1,2,2021-06-13,17:34:08,10776,10816,0,0,359.5,0,0,359.5,0,0,0,0,0,0,47145.6,47505.1,0,21.0,0,326.84,10.0,32.66,0,4.0,0,0,0.0,0,0,0,False,2021
149,001,1,2,2021-06-14,19:45:34,10817,10835,0,0,103.9,0,0,103.9,0,0,0,0,0,0,47505.1,47609,0,21.0,0,94.47,10.0,9.43,0,4.0,0,0,0.0,0,0,0,False,2021
150,001,1,2,2021-06-16,20:16:34,10836,10852,0,0,81,0,0,81,0,0,0,0,0,0,47609,47690,0,21.0,0,73.65,10.0,7.35,0,4.0,0,0,0.0,0,0,0,False,2021
151,001,1,2,2021-06-17,22:37:32,10853,10880,0,0,163.5,0,0,163.5,0,0,0,0,0,0,47690,47853.5,0,21.0,0,148.65,10.0,14.85,0,4.0,0,0,0.0,0,0,0,False,2021
152,001,1,2,2021-06-18,23:36:22,10881,10913,0,0,124.8,0,0,124.8,0,0,0,0,0,0,47853.5,47978.3,0,21.0,0,113.45,10.0,11.35,0,4.0,0,0,0.0,0,0,0,False,2021
153,001,1,2,2021-06-19,19:23:36,10914,10923,0,0,64.5,0,0,64.5,0,0,0,0,0,0,47978.3,48042.8,0,21.0,0,58.64,10.0,5.86,0,4.0,0,0,0.0,0,0,0,False,2021
154,001,1,2,2021-06-20,20:12:09,10924,10966,0,0,290.9,0,0,290.9,0,0,0,0,0,0,48042.8,48333.7,0,21.0,0,264.47,10.0,26.43,0,4.0,0,0,0.0,0,0,0,False,2021
155,001,1,2,2021-06-24,17:55:15,10967,10982,0,0,86.1,0,0,86.1,0,0,0,0,0,0,48333.7,48419.8,0,21.0,0,78.3,10.0,7.8,0,4.0,0,0,0.0,0,0,0,False,2021
156,001,1,2,2021-06-25,16:19:43,10983,11004,0,0,92,0,0,92,0,0,0,0,0,0,48419.8,48511.8,0,21.0,0,83.66,10.0,8.34,0,4.0,0,0,0.0,0,0,0,False,2021
157,001,1,2,2021-06-26,21:48:26,11005,11031,0,0,93.2,0,0,93.2,0,0,0,0,0,0,48511.8,48605,0,21.0,0,84.73,10.0,8.47,0,4.0,0,0,0.0,0,0,0,False,2021
158,001,1,2,2021-06-27,21:04:49,11032,11065,0,0,248,0,0,248,0,0,0,0,0,0,48605,48853,0,21.0,0,225.49,10.0,22.51,0,4.0,0,0,0.0,0,0,0,False,2021
159,001,1,2,2021-06-28,17:24:24,11066,11088,0,0,160.7,19.5,0,180.2,0,0,0,0,0,0,48853,49013.7,0,21.0,0,163.84,10.0,16.36,0,4.0,0,0,0.0,0,0,0,False,2021
160,001,1,2,2021-06-30,18:30:32,11089,11114,0,0,100.3,9.2,0,109.5,0,0,0,0,0,0,49013.7,49114,0,21.0,0,99.53,10.0,9.97,0,4.0,0,0,0.0,0,0,0,False,2021
161,001,1,2,2021-07-01,21:23:47,11115,11140,0,0,127.2,0,0,127.2,0,0,0,0,0,0,49114,49241.2,0,21.0,0,115.69,10.0,11.51,0,4.0,0,0,0.0,0,0,0,False,2021
162,001,1,2,2021-07-02,21:10:50,11141,11173,0,0,85.4,57,0,142.4,0,0,0,0,0,0,49241.2,49326.6,0,21.0,0,129.47,10.0,12.93,0,4.0,0,0,0.0,0,0,0,False,2021
163,001,1,2,2021-07-03,23:11:41,11174,11222,0,0,130.5,0,0,130.5,0,0,0,0,0,0,49326.6,49457.1,0.83,21.0,0.17,117.76,10.0,11.74,0,4.0,0,0,0.0,0,0,0,False,2021
164,001,1,2,2021-07-04,18:32:24,11223,11275,0,0,264.5,0,0,264.5,0,0,0,0,0,0,49457.1,49721.6,0,21.0,0,240.52,10.0,23.98,0,4.0,0,0,0.0,0,0,0,False,2021
165,001,1,2,2021-07-05,18:54:13,11276,11294,0,0,66.5,0,0,66.5,0,0,0,0,0,0,49721.6,49788.1,0,21.0,0,60.46,10.0,6.04,0,4.0,0,0,0.0,0,0,0,False,2021
166,001,1,2,2021-07-06,17:23:32,11295,11300,0,0,24,0,0,24,0,0,0,0,0,0,49788.1,49812.1,0,21.0,0,21.82,10.0,2.18,0,4.0,0,0,0.0,0,0,0,False,2021
167,001,1,2,2021-07-07,20:40:46,11301,11327,0,0,55.3,25.5,0,80.8,0,0,0,0,0,0,49812.1,49867.4,0,21.0,0,73.47,10.0,7.33,0,4.0,0,0,0.0,0,0,0,False,2021
168,001,1,2,2021-07-09,00:01:53,11328,11362,0,0,69.2,47,0,116.2,0,0,0,0,0,0,49867.4,49936.6,0,21.0,0,105.66,10.0,10.54,0,4.0,0,0,0.0,0,0,0,False,2021
169,001,1,2,2021-07-09,23:44:06,11363,11396,0,0,57.4,37.5,0,94.9,0,0,0,0,0,0,49936.6,49994,0,21.0,0,86.28,10.0,8.62,0,4.0,0,0,0.0,0,0,0,False,2021
170,001,1,2,2021-07-10,20:47:31,11397,11451,0,0,97.74,77.5,0,175.24,0,0,0,0,0,0,49994,50091.74,0.7,21.0,0.14,158.49,10.0,15.91,0,4.0,0,0,0.0,0,0,0,False,2021
171,001,1,2,2021-07-11,18:43:45,11452,11501,0,0,330.32,26,0,356.32,0,0,0,0,0,0,50091.74,50422.06,0.1,21.0,0.02,323.83,10.0,32.37,0,4.0,0,0,0.0,0,0,0,False,2021
172,001,1,2,2021-07-12,19:40:10,11502,11511,0,0,15.45,16,0,31.45,0,0,0,0,0,0,50422.06,50437.51,0.13,21.0,0.02,28.46,10.0,2.84,0,4.0,0,0,0.0,0,0,0,False,2021
173,001,1,2,2021-07-13,18:06:52,11512,11520,0,0,55,7,0,62,0,0,0,0,0,0,50437.51,50492.51,0,21.0,0,56.38,10.0,5.62,0,4.0,0,0,0.0,0,0,0,False,2021
174,001,1,2,2021-07-14,20:37:17,11521,11527,0,0,48.1,0,0,48.1,0,0,0,0,0,0,50492.51,50540.61,0,21.0,0,43.72,10.0,4.38,0,4.0,0,0,0.0,0,0,0,False,2021
175,001,1,2,2021-07-15,20:28:05,11528,11543,0,0,58.72,20,0,78.72,0,0,0,0,0,0,50540.61,50599.33,0.6,21.0,0.12,70.91,10.0,7.09,0,4.0,0,0,0.0,0,0,0,False,2021
176,001,1,2,2021-07-16,21:37:53,11544,11570,0,0,122.6,11,0,133.6,0,0,0,0,0,0,50599.33,50721.93,0,21.0,0,121.43,10.0,12.17,0,4.0,0,0,0.0,0,0,0,False,2021
177,001,1,2,2021-07-17,19:08:14,11571,11597,0,0,165.3,91.2,0,256.5,0,0,0,0,0,0,50721.93,50887.23,8.6,21.0,1.8,223.72,10.0,22.38,0,4.0,0,0,0.0,0,0,0,False,2021
178,001,1,2,2021-07-18,17:45:01,11598,11642,0,0,401.94,60,0,461.94,0,0,0,0,0,0,50887.23,51289.17,0.7,21.0,0.15,419.21,10.0,41.89,0,4.0,0,0,0.0,0,0,0,False,2021
179,001,1,2,2021-07-19,17:31:45,11643,11647,0,0,23,0,0,23,0,0,0,0,0,0,51289.17,51312.17,0,21.0,0,20.92,10.0,2.08,0,4.0,0,0,0.0,0,0,0,False,2021
180,001,1,2,2021-07-20,18:35:42,11648,11662,0,0,55.3,0,0,55.3,0,0,0,0,0,0,51312.17,51367.47,0,21.0,0,50.26,10.0,5.04,0,4.0,0,0,0.0,0,0,0,False,2021
181,001,1,2,2021-07-22,00:23:09,11663,11692,0,0,63.3,35,0,98.3,0,0,0,0,0,0,51367.47,51430.77,0,21.0,0,89.39,10.0,8.91,0,4.0,0,0,0.0,0,0,0,False,2021
182,001,1,2,2021-07-22,21:16:44,11693,11705,0,0,21.1,65,0,86.1,0,0,0,0,0,0,51430.77,51451.87,0,21.0,0,78.27,10.0,7.83,0,4.0,0,0,0.0,0,0,0,False,2021
183,001,1,2,2021-07-23,22:30:11,11706,11737,0,0,58.3,39,0,97.3,0,0,0,0,0,0,51451.87,51510.17,0,21.0,0,88.46,10.0,8.84,0,4.0,0,0,0.0,0,0,0,False,2021
184,001,1,2,2021-07-24,20:06:32,11738,11768,0,0,31,24,0,55,0,0,0,0,0,0,51510.17,51541.17,0,21.0,0,49.99,10.0,5.01,0,4.0,0,0,0.0,0,0,0,False,2021
185,001,1,2,2021-07-25,18:36:52,11769,11835,0,0,450.1,188.4,0,638.5,0,0,0,0,0,0,51541.17,51991.27,0,21.0,0,580.42,10.0,58.08,0,4.0,0,0,0.0,0,0,0,False,2021
186,001,1,2,2021-07-26,18:16:30,11836,11870,0,0,69.2,54.5,0,123.7,0,0,0,0,0,0,51991.27,52060.47,0,21.0,0,112.45,10.0,11.25,0,4.0,0,0,0.0,0,0,0,False,2021
187,001,1,2,2021-07-27,18:23:13,11871,11886,0,0,20.5,30.5,0,51,0,0,0,0,0,0,52060.47,52080.97,0,21.0,0,46.39,10.0,4.61,0,4.0,0,0,0.0,0,0,0,False,2021
188,001,1,2,2021-07-28,18:57:50,11887,11906,0,0,50.32,35,0,85.32,0,0,0,0,0,0,52080.97,52131.29,0.1,21.0,0.02,77.47,10.0,7.73,0,4.0,0,0,0.0,0,0,0,False,2021
189,001,1,2,2021-07-29,17:47:32,11907,11932,0,0,44.2,32.5,0,76.7,0,0,0,0,0,0,52131.29,52175.49,0,21.0,0,69.72,10.0,6.98,0,4.0,0,0,0.0,0,0,0,False,2021
190,001,1,2,2021-07-30,20:48:47,11933,11965,0,0,42,51.5,0,93.5,0,0,0,0,0,0,52175.49,52217.49,0,21.0,0,85.03,10.0,8.47,0,4.0,0,0,0.0,0,0,0,False,2021
191,001,1,2,2021-07-31,20:59:38,11966,12014,0,0,366,61.7,0,427.7,0,0,0,0,0,0,52217.49,52583.49,3.31,21.0,0.69,385.22,10.0,38.48,0,4.0,0,0,0.0,0,0,0,False,2021
192,001,1,2,2021-08-01,18:27:54,12015,12085,0,0,519.7,123.7,0,643.4,0,0,0,0,0,0,52583.49,53103.19,11.24,21.0,2.36,572.53,10.0,57.27,0,4.0,0,0,0.0,0,0,0,False,2021
193,001,1,2,2021-08-02,18:52:15,12086,12101,0,0,87.9,51,0,138.9,0,0,0,0,0,0,53103.19,53191.09,2.48,21.0,0.52,123.56,10.0,12.34,0,4.0,0,0,0.0,0,0,0,False,2021
194,001,1,2,2021-08-03,19:06:29,12102,12111,0,0,12.7,92.2,0,104.9,0,0,0,0,0,0,53191.09,53203.79,0,21.0,0,95.36,10.0,9.54,0,4.0,0,0,0.0,0,0,0,False,2021
195,001,1,2,2021-08-04,19:56:58,12112,12120,0,0,64.5,35,0,99.5,0,0,0,0,0,0,53203.79,53268.29,0,21.0,0,90.47,10.0,9.03,0,4.0,0,0,0.0,0,0,0,False,2021
196,001,1,2,2021-08-05,17:40:37,12121,12129,0,0,50.9,18.5,0,69.4,0,0,0,0,0,0,53268.29,53319.19,0,21.0,0,63.1,10.0,6.3,0,4.0,0,0,0.0,0,0,0,False,2021
197,001,1,2,2021-08-06,19:28:28,12130,12141,0,0,0,137.2,0,137.2,0,0,0,0,0,0,53319.19,53319.19,0,21.0,0,124.75,10.0,12.45,0,4.0,0,0,0.0,0,0,0,False,2021
198,001,1,2,2021-08-07,18:05:07,12142,12186,0,0,279.72,256.1,0,535.82,0,0,0,0,0,0,53319.19,53598.91,10.84,21.0,2.28,475.21,10.0,47.49,0,4.0,0,0,0.0,0,0,0,False,2021
199,001,1,2,2021-08-08,16:06:39,12187,12243,0,0,537,116.2,0,653.2,0,0,0,0,0,0,53598.91,54135.91,9.92,21.0,2.08,582.9,10.0,58.3,0,4.0,0,0,0.0,0,0,0,False,2021
200,001,1,2,2021-08-09,16:47:17,12244,12283,0,0,72.9,88.4,0,161.3,0,0,0,0,0,0,54135.91,54208.81,12.4,21.0,2.6,133.02,10.0,13.28,0,4.0,0,0,0.0,0,0,0,False,2021
201,001,1,2,2021-08-10,18:24:27,12284,12308,0,0,88,49,0,137,0,0,0,0,0,0,54208.81,54296.81,0,21.0,0,124.56,10.0,12.44,0,4.0,0,0,0.0,0,0,0,False,2021
202,001,1,2,2021-08-11,18:03:03,12309,12343,0,0,59,105,0,164,0,0,0,0,0,0,54296.81,54355.81,0,21.0,0,149.12,10.0,14.88,0,4.0,0,0,0.0,0,0,0,False,2021
203,001,1,2,2021-08-12,18:23:37,12344,12391,0,0,83.52,108.5,0,192.02,0,0,0,0,0,0,54355.81,54439.33,0.1,21.0,0.02,174.48,10.0,17.42,0,4.0,0,0,0.0,0,0,0,False,2021
204,001,1,2,2021-08-13,18:58:34,12392,12440,0,0,60.9,53,0,113.9,0,0,0,0,0,0,54439.33,54500.23,0,21.0,0,103.56,10.0,10.34,0,4.0,0,0,0.0,0,0,0,False,2021
205,001,1,2,2021-08-14,18:48:18,12441,12501,0,0,505.4,200.5,0,705.9,0,0,0,0,0,0,54500.23,55005.63,8.26,21.0,1.74,632.62,10.0,63.28,0,4.0,0,0,0.0,0,0,0,False,2021
206,001,1,2,2021-08-15,16:54:24,12502,12558,0,0,525.3,56.5,0,581.8,0,0,0,0,0,0,55005.63,55530.93,0,21.0,0,528.95,10.0,52.85,0,4.0,0,0,0.0,0,0,0,False,2021
207,001,1,2,2021-08-16,17:29:31,12559,12605,0,0,77.7,30,0,107.7,0,0,0,0,0,0,55530.93,55608.63,0,21.0,0,97.9,10.0,9.8,0,4.0,0,0,0.0,0,0,0,False,2021
208,001,1,2,2021-08-17,18:38:22,12606,12641,0,0,51.9,23.2,0,75.1,0,0,0,0,0,0,55608.63,55660.53,0,21.0,0,68.27,10.0,6.83,0,4.0,0,0,0.0,0,0,0,False,2021
209,001,1,2,2021-08-18,16:13:57,12642,12680,0,0,38.1,65.9,0,104,0,0,0,0,0,0,55660.53,55698.63,0,21.0,0,94.56,10.0,9.44,0,4.0,0,0,0.0,0,0,0,False,2021
210,001,1,2,2021-08-19,17:15:32,12681,12721,0,0,61.4,55.4,0,116.8,0,0,0,0,0,0,55698.63,55760.03,0,21.0,0,106.23,10.0,10.57,0,4.0,0,0,0.0,0,0,0,False,2021
211,001,1,2,2021-08-20,17:24:40,12722,12774,0,0,108.9,36.5,0,145.4,0,0,0,0,0,0,55760.03,55868.93,0,21.0,0,132.17,10.0,13.23,0,4.0,0,0,0.0,0,0,0,False,2021
212,001,1,2,2021-08-21,16:50:37,12775,12835,0,0,344.6,178.7,0,523.3,0,0,0,0,0,0,55868.93,56213.53,0,21.0,0,475.78,10.0,47.52,0,4.0,0,0,0.0,0,0,0,False,2021
213,001,1,2,2021-08-22,16:08:33,12836,12882,0,0,281.4,94.5,0,375.9,0,0,0,0,0,0,56213.53,56494.93,0,21.0,0,341.72,10.0,34.18,0,4.0,0,0,0.0,0,0,0,False,2021
214,001,1,2,2021-08-23,16:35:30,12883,12935,0,0,88.6,43,0,131.6,0,0,0,0,0,0,56494.93,56583.53,0,21.0,0,119.66,10.0,11.94,0,4.0,0,0,0.0,0,0,0,False,2021
215,001,1,2,2021-08-24,17:31:24,12936,12977,0,0,61.1,57,0,118.1,0,0,0,0,0,0,56583.53,56644.63,0,21.0,0,107.39,10.0,10.71,0,4.0,0,0,0.0,0,0,0,False,2021
216,001,1,2,2021-08-25,16:37:26,12978,13033,0,0,55.5,65.5,0,121,0,0,0,0,0,0,56644.63,56700.13,0,21.0,0,109.99,10.0,11.01,0,4.0,0,0,0.0,0,0,0,False,2021
217,001,1,2,2021-08-25,16:49:54,13034,13045,0,0,12.62,0,0,12.62,0,0,0,0,0,0,56700.13,56712.75,0.1,21.0,0.02,11.37,10.0,1.13,0,4.0,0,0,0.0,0,0,0,False,2021
218,001,1,2,2021-08-26,17:10:02,13046,13070,0,0,23.5,51,0,74.5,0,0,0,0,0,0,56712.75,56736.25,0,21.0,0,67.73,10.0,6.77,0,4.0,0,0,0.0,0,0,0,False,2021
219,001,1,2,2021-08-27,17:48:37,13071,13112,0,0,60.5,21.5,0,82,0,0,0,0,0,0,56736.25,56796.75,0,21.0,0,74.53,10.0,7.47,0,4.0,0,0,0.0,0,0,0,False,2021
220,001,1,2,2021-08-28,19:59:58,13113,13174,0,0,121.6,105.4,0,227,0,0,0,0,0,0,56796.75,56918.35,0,21.0,0,206.35,10.0,20.65,0,4.0,0,0,0.0,0,0,0,False,2021
221,001,1,2,2021-08-29,16:04:44,13175,13231,0,0,396.8,157,0,553.8,0,0,0,0,0,0,56918.35,57315.15,2.48,21.0,0.52,500.77,10.0,50.03,0,4.0,0,0,0.0,0,0,0,False,2021
222,001,1,2,2021-08-30,17:57:20,13232,13281,0,0,84.5,91.7,0,176.2,0,0,0,0,0,0,57315.15,57399.65,0,21.0,0,160.15,10.0,16.05,0,4.0,0,0,0.0,0,0,0,False,2021
223,001,1,2,2021-08-31,15:55:07,13282,13317,0,0,32.4,50,0,82.4,0,0,0,0,0,0,57399.65,57432.05,0,21.0,0,74.89,10.0,7.51,0,4.0,0,0,0.0,0,0,0,False,2021
224,001,1,2,2021-09-01,16:47:56,13318,13352,0,0,77,75,0,152,0,0,0,0,0,0,57432.05,57509.05,0,21.0,0,138.21,10.0,13.79,0,4.0,0,0,0.0,0,0,0,False,2021
225,001,1,2,2021-09-02,17:59:29,13353,13396,0,0,167.2,50.5,0,217.7,0,0,0,0,0,0,57509.05,57676.25,0,21.0,0,197.93,10.0,19.77,0,4.0,0,0,0.0,0,0,0,False,2021
226,001,1,2,2021-09-03,17:29:41,13397,13420,0,0,34.5,30,0,64.5,0,0,0,0,0,0,57676.25,57710.75,0,21.0,0,58.64,10.0,5.86,0,4.0,0,0,0.0,0,0,0,False,2021
227,001,1,2,2021-09-04,16:54:45,13421,13474,0,0,67.32,66,0,133.32,0,0,0,0,0,0,57710.75,57778.07,0.1,21.0,0.02,121.08,10.0,12.12,0,4.0,0,0,0.0,0,0,0,False,2021
228,001,1,2,2021-09-05,15:10:15,13475,13526,0,0,469.4,53,0,522.4,0,0,0,0,0,0,57778.07,58247.47,0,21.0,0,474.93,10.0,47.47,0,4.0,0,0,0.0,0,0,0,False,2021
229,001,1,2,2021-09-06,18:08:37,13527,13569,0,0,61.9,27.5,0,89.4,0,0,0,0,0,0,58247.47,58309.37,0,21.0,0,81.28,10.0,8.12,0,4.0,0,0,0.0,0,0,0,False,2021
230,001,1,2,2021-09-07,15:27:37,13570,13596,0,0,29.2,17,0,46.2,0,0,0,0,0,0,58309.37,58338.57,0,21.0,0,41.98,10.0,4.22,0,4.0,0,0,0.0,0,0,0,False,2021
231,001,1,2,2021-09-08,17:30:42,13597,13615,0,0,23.7,101,0,124.7,0,0,0,0,0,0,58338.57,58362.27,0,21.0,0,113.38,10.0,11.32,0,4.0,0,0,0.0,0,0,0,False,2021
232,001,1,2,2021-09-08,17:38:01,13616,13621,0,0,6,0,0,6,0,0,0,0,0,0,58362.27,58368.27,0,21.0,0,5.46,10.0,0.54,0,4.0,0,0,0.0,0,0,0,False,2021
233,001,1,2,2021-09-09,16:18:35,13622,13644,0,0,23,17.5,0,40.5,0,0,0,0,0,0,58368.27,58391.27,0,21.0,0,36.82,10.0,3.68,0,4.0,0,0,0.0,0,0,0,False,2021
234,001,1,2,2021-09-10,16:42:08,13645,13680,0,0,79,89.5,0,168.5,0,0,0,0,0,0,58391.27,58470.27,0,21.0,0,153.16,10.0,15.34,0,4.0,0,0,0.0,0,0,0,False,2021
235,001,1,2,2021-09-11,16:18:08,13681,13718,0,0,34,26.5,0,60.5,0,0,0,0,0,0,58470.27,58504.27,0,21.0,0,55,10.0,5.5,0,4.0,0,0,0.0,0,0,0,False,2021
236,001,1,2,2021-09-12,16:29:54,13719,13779,0,0,486.5,42.5,0,529,0,0,0,0,0,0,58504.27,58990.77,0,21.0,0,480.94,10.0,48.06,0,4.0,0,0,0.0,0,0,0,False,2021
237,001,1,2,2021-09-13,18:36:54,13780,13812,0,0,86.9,56.5,0,143.4,0,0,0,0,0,0,58990.77,59077.67,0,21.0,0,130.39,10.0,13.01,0,4.0,0,0,0.0,0,0,0,False,2021
238,001,1,2,2021-09-14,14:57:05,13813,13850,0,0,42.5,55,0,97.5,0,0,0,0,0,0,59077.67,59120.17,0,21.0,0,88.62,10.0,8.88,0,4.0,0,0,0.0,0,0,0,False,2021
239,001,1,2,2021-09-15,15:34:54,13851,13871,0,0,40.7,62,0,102.7,0,0,0,0,0,0,59120.17,59160.87,0,21.0,0,93.36,10.0,9.34,0,4.0,0,0,0.0,0,0,0,False,2021
240,001,1,2,2021-09-16,19:00:08,13872,13900,0,0,28.5,34.2,0,62.7,0,0,0,0,0,0,59160.87,59189.37,0,21.0,0,56.99,10.0,5.71,0,4.0,0,0,0.0,0,0,0,False,2021
241,001,1,2,2021-09-17,17:35:33,13901,13936,0,0,43,27,0,70,0,0,0,0,0,0,59189.37,59232.37,0,21.0,0,63.64,10.0,6.36,0,4.0,0,0,0.0,0,0,0,False,2021
242,001,1,2,2021-09-18,17:49:03,13937,13972,0,0,54.8,129.3,0,184.1,0,0,0,0,0,0,59232.37,59287.17,2.48,21.0,0.52,164.63,10.0,16.47,0,4.0,0,0,0.0,0,0,0,False,2021
243,001,1,2,2021-09-19,17:29:56,13973,14026,0,0,411.8,112,0,523.8,0,0,0,0,0,0,59287.17,59698.97,0,21.0,0,476.19,10.0,47.61,0,4.0,0,0,0.0,0,0,0,False,2021
244,001,1,2,2021-09-20,16:23:06,14027,14045,0,0,17.5,154.5,0,172,0,0,0,0,0,0,59698.97,59716.47,0,21.0,0,156.38,10.0,15.62,0,4.0,0,0,0.0,0,0,0,False,2021
245,001,1,2,2021-09-22,15:57:26,14046,14064,0,0,74.7,61.5,0,136.2,0,0,0,0,0,0,59716.47,59791.17,0,21.0,0,123.83,10.0,12.37,0,4.0,0,0,0.0,0,0,0,False,2021
246,001,1,2,2021-09-23,18:12:38,14065,14094,0,0,30,36,0,66,0,0,0,0,0,0,59791.17,59821.17,0,21.0,0,59.98,10.0,6.02,0,4.0,0,0,0.0,0,0,0,False,2021
247,001,1,2,2021-09-24,16:22:05,14095,14133,0,0,67.9,75,0,142.9,0,0,0,0,0,0,59821.17,59889.07,0,21.0,0,129.89,10.0,13.01,0,4.0,0,0,0.0,0,0,0,False,2021
248,001,1,2,2021-09-25,18:06:19,14134,14197,0,0,505.9,83,0,588.9,0,0,0,0,0,0,59889.07,60394.97,0,21.0,0,535.35,10.0,53.55,0,4.0,0,0,0.0,0,0,0,False,2021
249,001,1,2,2021-09-26,20:31:35,14198,14282,0,0,676.9,215.4,0,892.3,0,0,0,0,0,0,60394.97,61071.87,2.48,21.0,0.52,808.47,10.0,80.83,0,4.0,0,0,0.0,0,0,0,False,2021
250,001,1,2,2021-09-27,12:44:52,14283,14299,0,0,83,53.5,0,136.5,0,0,0,0,0,0,61071.87,61154.87,0,21.0,0,124.11,10.0,12.39,0,4.0,0,0,0.0,0,0,0,False,2021
251,001,1,2,2021-09-29,18:16:15,14300,14317,0,0,50.5,26.6,0,77.1,0,0,0,0,0,0,61154.87,61205.37,0,21.0,0,70.12,10.0,6.98,0,4.0,0,0,0.0,0,0,0,False,2021
252,001,1,2,2021-09-30,18:34:23,14318,14346,0,0,71.6,39,0,110.6,0,0,0,0,0,0,61205.37,61276.97,0,21.0,0,100.55,10.0,10.05,0,4.0,0,0,0.0,0,0,0,False,2021
253,001,1,2,2021-10-01,17:21:14,14347,14379,0,0,66.5,79,0,145.5,0,0,0,0,0,0,61276.97,61343.47,0,21.0,0,132.29,10.0,13.21,0,4.0,0,0,0.0,0,0,0,False,2021
254,001,1,2,2021-10-02,17:40:52,14380,14435,0,0,347.3,73,0,420.3,0,0,0,0,0,0,61343.47,61690.77,0,21.0,0,382.11,10.0,38.19,0,4.0,0,0,0.0,0,0,0,False,2021
255,001,1,2,2021-10-03,17:35:15,14436,14497,0,0,405.9,164.9,0,570.8,0,0,0,0,0,0,61690.77,62096.67,2.48,21.0,0.52,516.15,10.0,51.65,0,4.0,0,0,0.0,0,0,0,False,2021
256,001,1,2,2021-10-04,16:45:58,14498,14536,0,0,72.3,46.7,0,119,0,0,0,0,0,0,62096.67,62168.97,0,21.0,0,108.21,10.0,10.79,0,4.0,0,0,0.0,0,0,0,False,2021
257,001,1,2,2021-10-06,17:23:24,14537,14577,0,0,47,56.2,0,103.2,0,0,0,0,0,0,62168.97,62215.97,0,21.0,0,93.83,10.0,9.37,0,4.0,0,0,0.0,0,0,0,False,2021
258,001,1,2,2021-10-07,19:23:45,14578,14617,0,0,38.4,32.2,0,70.6,0,0,0,0,0,0,62215.97,62254.37,1,21.0,0.2,63.07,10.0,6.33,0,4.0,0,0,0.0,0,0,0,False,2021
259,001,1,2,2021-10-08,16:48:43,14618,14641,0,0,34.6,13.4,0,48,0,0,0,0,0,0,62254.37,62288.97,0,21.0,0,43.62,10.0,4.38,0,4.0,0,0,0.0,0,0,0,False,2021
260,001,1,2,2021-10-09,19:20:24,14642,14696,0,0,508,176.6,0,684.6,0,0,0,0,0,0,62288.97,62796.97,14.88,21.0,3.12,605.96,10.0,60.64,0,4.0,0,0,0.0,0,0,0,False,2021
261,001,1,2,2021-10-10,17:10:08,14697,14769,0,0,476.92,68.22,0,545.14,0,0,0,0,0,0,62796.97,63273.89,0.7,21.0,0.14,494.82,10.0,49.48,0,4.0,0,0,0.0,0,0,0,False,2021
262,001,1,2,2021-10-11,20:08:23,14770,14806,0,0,90.2,28,0,118.2,0,0,0,0,0,0,63273.89,63364.09,0,21.0,0,107.49,10.0,10.71,0,4.0,0,0,0.0,0,0,0,False,2021
263,001,1,2,2021-10-12,19:02:42,14807,14870,0,0,119.5,159.2,0,278.7,0,0,0,0,0,0,63364.09,63483.59,0,21.0,0,253.37,10.0,25.33,0,4.0,0,0,0.0,0,0,0,False,2021
264,001,1,2,2021-10-13,17:10:25,14871,14902,0,0,71.5,62.5,0,134,0,0,0,0,0,0,63483.59,63555.09,0,21.0,0,121.83,10.0,12.17,0,4.0,0,0,0.0,0,0,0,False,2021
265,001,1,2,2021-10-14,16:52:22,14903,14925,0,0,20.4,40.5,0,60.9,0,0,0,0,0,0,63555.09,63575.49,0,21.0,0,55.32,10.0,5.58,0,4.0,0,0,0.0,0,0,0,False,2021
266,001,1,2,2021-10-15,18:57:47,14926,14958,0,0,66.8,37.2,0,104,0,0,0,0,0,0,63575.49,63642.29,0,21.0,0,94.53,10.0,9.47,0,4.0,0,0,0.0,0,0,0,False,2021
267,001,1,2,2021-10-16,18:17:58,14959,15001,0,0,52.7,16.5,0,69.2,0,0,0,0,0,0,63642.29,63694.99,0,21.0,0,62.9,10.0,6.3,0,4.0,0,0,0.0,0,0,0,False,2021
268,001,1,2,2021-10-17,16:25:35,15002,15044,0,0,327.2,64.5,0,391.7,0,0,0,0,0,0,63694.99,64022.19,0.99,21.0,0.21,354.97,10.0,35.53,0,4.0,0,0,0.0,0,0,0,False,2021
269,001,1,2,2021-10-18,17:59:15,15045,15080,0,0,41.9,52,0,93.9,0,0,0,0,0,0,64022.19,64064.09,0,21.0,0,85.35,10.0,8.55,0,4.0,0,0,0.0,0,0,0,False,2021
270,001,1,2,2021-10-20,16:36:48,15081,15110,0,0,51.7,38,0,89.7,0,0,0,0,0,0,64064.09,64115.79,0,21.0,0,81.55,10.0,8.15,0,4.0,0,0,0.0,0,0,0,False,2021
271,001,1,2,2021-10-21,17:30:40,15111,15135,0,0,25.9,46.5,0,72.4,0,0,0,0,0,0,64115.79,64141.69,0,21.0,0,65.82,10.0,6.58,0,4.0,0,0,0.0,0,0,0,False,2021
272,001,1,2,2021-10-22,18:18:40,15136,15173,0,0,65.5,14,0,79.5,0,0,0,0,0,0,64141.69,64207.19,0,21.0,0,72.25,10.0,7.25,0,4.0,0,0,0.0,0,0,0,False,2021
273,001,1,2,2021-10-23,20:00:00,15174,15225,0,0,394.9,72.7,0,467.6,0,0,0,0,0,0,64207.19,64602.09,0,21.0,0,425.11,10.0,42.49,0,4.0,0,0,0.0,0,0,0,False,2021
274,001,1,2,2021-10-24,17:59:29,15226,15281,0,0,342.32,163,0,505.32,0,0,0,0,0,0,64602.09,64944.41,10.02,21.0,2.1,448.4,10.0,44.8,0,4.0,0,0,0.0,0,0,0,False,2021
275,001,1,2,2021-10-25,16:02:20,15282,15313,0,0,87.2,39.9,0,127.1,0,0,0,0,0,0,64944.41,65031.61,0,21.0,0,115.56,10.0,11.54,0,4.0,0,0,0.0,0,0,0,False,2021
276,001,1,2,2021-10-27,17:04:57,15314,15343,0,0,43.5,34,0,77.5,0,0,0,0,0,0,65031.61,65075.11,0,21.0,0,70.45,10.0,7.05,0,4.0,0,0,0.0,0,0,0,False,2021
277,001,1,2,2021-10-28,15:51:34,15344,15370,0,0,26.5,39.9,0,66.4,0,0,0,0,0,0,65075.11,65101.61,0,21.0,0,60.37,10.0,6.03,0,4.0,0,0,0.0,0,0,0,False,2021
278,001,1,2,2021-10-29,17:39:21,15371,15405,0,0,49.7,74.3,0,124,0,0,0,0,0,0,65101.61,65151.31,0,21.0,0,112.72,10.0,11.28,0,4.0,0,0,0.0,0,0,0,False,2021
279,001,1,2,2021-10-30,18:03:42,15406,15463,0,0,463.8,101.5,0,565.3,0,0,0,0,0,0,65151.31,65615.11,24.79,21.0,5.21,486.63,10.0,48.67,0,4.0,0,0,0.0,0,0,0,False,2021
280,001,1,2,2021-10-31,16:03:25,15464,15526,0,0,568.7,92.5,0,661.2,0,0,0,0,0,0,65615.11,66183.81,0,21.0,0,601.12,10.0,60.08,0,4.0,0,0,0.0,0,0,0,False,2021
281,001,1,2,2021-11-01,16:42:56,15527,15561,0,0,240.8,146,0,386.8,0,0,0,0,0,0,66183.81,66424.61,4.79,21.0,1.01,346.39,10.0,34.61,0,4.0,0,0,0.0,0,0,0,False,2021
282,001,1,2,2021-11-04,17:24:22,15562,15599,0,0,54.7,97.4,0,152.1,0,0,0,0,0,0,66424.61,66479.31,0,21.0,0,138.26,10.0,13.84,0,4.0,0,0,0.0,0,0,0,False,2021
283,001,1,2,2021-11-05,17:54:22,15600,15641,0,0,52.2,61.5,0,113.7,0,0,0,0,0,0,66479.31,66531.51,0,21.0,0,103.35,10.0,10.35,0,4.0,0,0,0.0,0,0,0,False,2021
284,001,1,2,2021-11-06,19:24:03,15642,15706,0,0,398.28,84.5,0,482.78,0,0,0,0,0,0,66531.51,66929.79,0.4,21.0,0.08,438.48,10.0,43.82,0,4.0,0,0,0.0,0,0,0,False,2021
285,001,1,2,2021-11-07,16:05:11,15707,15762,0,0,364.9,77.5,0,442.4,0,0,0,0,0,0,66929.79,67294.69,0,21.0,0,402.18,10.0,40.22,0,4.0,0,0,0.0,0,0,0,False,2021
286,001,1,2,2021-11-08,17:20:53,15763,15808,0,0,77.7,25,0,102.7,0,0,0,0,0,0,67294.69,67372.39,0,21.0,0,93.34,10.0,9.36,0,4.0,0,0,0.0,0,0,0,False,2021
287,001,1,2,2021-11-10,17:12:16,15809,15831,0,0,78.7,4.5,0,83.2,0,0,0,0,0,0,67372.39,67451.09,0,21.0,0,75.62,10.0,7.58,0,4.0,0,0,0.0,0,0,0,False,2021
288,001,1,2,2021-11-11,16:29:49,15832,15866,0,0,41.2,69.5,0,110.7,0,0,0,0,0,0,67451.09,67492.29,0,21.0,0,100.62,10.0,10.08,0,4.0,0,0,0.0,0,0,0,False,2021
289,001,1,2,2021-11-12,15:25:07,15867,15904,0,0,64,56,0,120,0,0,0,0,0,0,67492.29,67556.29,0,21.0,0,109.07,10.0,10.93,0,4.0,0,0,0.0,0,0,0,False,2021
290,001,1,2,2021-11-13,17:00:31,15905,15968,0,0,353.52,101.5,0,455.02,0,0,0,0,0,0,67556.29,67909.81,0.1,21.0,0.02,413.52,10.0,41.38,0,4.0,0,0,0.0,0,0,0,False,2021
291,001,1,2,2021-11-14,18:17:40,15969,16037,0,0,512,96.7,0,608.7,0,0,0,0,0,0,67909.81,68421.81,0.66,21.0,0.14,552.64,10.0,55.26,0,4.0,0,0,0.0,0,0,0,False,2021
292,001,1,2,2021-11-15,16:43:09,16038,16080,0,0,86,74.5,0,160.5,0,0,0,0,0,0,68421.81,68507.81,0,21.0,0,145.91,10.0,14.59,0,4.0,0,0,0.0,0,0,0,False,2021
293,001,1,2,2021-11-17,16:09:55,16081,16095,0,0,33.2,0,0,33.2,0,0,0,0,0,0,68507.81,68541.01,0,21.0,0,30.19,10.0,3.01,0,4.0,0,0,0.0,0,0,0,False,2021
294,001,1,2,2021-11-18,17:32:38,16096,16128,0,0,63.3,48,0,111.3,0,0,0,0,0,0,68541.01,68604.31,0,21.0,0,101.2,10.0,10.1,0,4.0,0,0,0.0,0,0,0,False,2021
295,001,1,2,2021-11-19,16:22:23,16129,16170,0,0,105.3,47,0,152.3,0,0,0,0,0,0,68604.31,68709.61,0,21.0,0,138.44,10.0,13.86,0,4.0,0,0,0.0,0,0,0,False,2021
296,001,1,2,2021-11-20,17:19:41,16171,16219,0,0,315.9,147.5,0,463.4,0,0,0,0,0,0,68709.61,69025.51,0,21.0,0,421.28,10.0,42.12,0,4.0,0,0,0.0,0,0,0,False,2021
297,001,1,2,2021-11-20,18:35:20,16220,16221,0,0,22,0,0,22,0,0,0,0,0,0,69025.51,69047.51,0,21.0,0,20,10.0,2,0,4.0,0,0,0.0,0,0,0,False,2021
298,001,1,2,2021-11-21,19:35:43,16222,16287,0,0,473.7,68,0,541.7,0,0,0,0,0,0,69047.51,69521.21,0,21.0,0,492.44,10.0,49.26,0,4.0,0,0,0.0,0,0,0,False,2021
299,001,1,2,2021-11-22,16:35:09,16288,16315,0,0,53.9,37,0,90.9,0,0,0,0,0,0,69521.21,69575.11,0,21.0,0,82.63,10.0,8.27,0,4.0,0,0,0.0,0,0,0,False,2021
300,001,1,2,2021-11-24,14:54:41,16316,16346,0,0,51.2,19,0,70.2,0,0,0,0,0,0,69575.11,69626.31,0,21.0,0,63.81,10.0,6.39,0,4.0,0,0,0.0,0,0,0,False,2021
301,001,1,2,2021-11-25,18:02:00,16347,16377,0,0,63.7,42,0,105.7,0,0,0,0,0,0,69626.31,69690.01,0,21.0,0,96.09,10.0,9.61,0,4.0,0,0,0.0,0,0,0,False,2021
302,001,1,2,2021-11-26,16:34:40,16378,16406,0,0,39.6,44.2,0,83.8,0,0,0,0,0,0,69690.01,69729.61,0.99,21.0,0.21,75.07,10.0,7.53,0,4.0,0,0,0.0,0,0,0,False,2021
303,001,1,2,2021-11-27,19:40:21,16407,16461,0,0,347.5,104.4,0,451.9,0,0,0,0,0,0,69729.61,70077.11,1.66,21.0,0.34,409.03,10.0,40.87,0,4.0,0,0,0.0,0,0,0,False,2021
304,001,1,2,2021-11-28,15:50:58,16462,16513,0,0,414.1,113,0,527.1,0,0,0,0,0,0,70077.11,70491.21,2.48,21.0,0.52,476.45,10.0,47.65,0,4.0,0,0,0.0,0,0,0,False,2021
305,001,1,2,2021-11-29,16:04:59,16514,16562,0,0,84.6,0,0,84.6,0,0,0,0,0,0,70491.21,70575.81,0,21.0,0,76.91,10.0,7.69,0,4.0,0,0,0.0,0,0,0,False,2021
306,001,1,2,2021-11-30,15:58:11,16563,16596,0,0,65.1,45,0,110.1,0,0,0,0,0,0,70575.81,70640.91,0,21.0,0,100.09,10.0,10.01,0,4.0,0,0,0.0,0,0,0,False,2021
307,001,1,2,2021-12-01,15:57:53,16597,16633,0,0,60.6,19.5,0,80.1,0,0,0,0,0,0,70640.91,70701.51,0,21.0,0,72.79,10.0,7.31,0,4.0,0,0,0.0,0,0,0,False,2021
308,001,1,2,2021-12-02,17:20:53,16634,16668,0,0,69.2,75,0,144.2,0,0,0,0,0,0,70701.51,70770.71,0,21.0,0,131.08,10.0,13.12,0,4.0,0,0,0.0,0,0,0,False,2021
309,001,1,2,2021-12-03,17:02:22,16669,16702,0,0,55.5,79,0,134.5,0,0,0,0,0,0,70770.71,70826.21,0,21.0,0,122.28,10.0,12.22,0,4.0,0,0,0.0,0,0,0,False,2021
310,001,1,2,2021-12-04,17:12:57,16703,16772,0,0,462.4,105.5,0,567.9,0,0,0,0,0,0,70826.21,71288.61,0,21.0,0,516.28,10.0,51.62,0,4.0,0,0,0.0,0,0,0,False,2021
311,001,1,2,2021-12-05,19:31:37,16773,16840,0,0,446.1,125,0,571.1,0,0,0,0,0,0,71288.61,71734.71,0,21.0,0,519.18,10.0,51.92,0,4.0,0,0,0.0,0,0,0,False,2021
312,001,1,2,2021-12-06,17:15:07,16841,16894,0,0,396.5,31.5,0,428,0,0,0,0,0,0,71734.71,72131.21,0,21.0,0,389.14,10.0,38.86,0,4.0,0,0,0.0,0,0,0,False,2021
313,001,1,2,2021-12-07,16:36:24,16895,16953,0,0,151,24.5,0,175.5,0,0,0,0,0,0,72131.21,72282.21,0,21.0,0,159.55,10.0,15.95,0,4.0,0,0,0.0,0,0,0,False,2021
314,001,1,2,2021-12-08,19:03:05,16954,17021,0,0,193,303.1,0,496.1,0,0,0,0,0,0,72282.21,72475.21,2.48,21.0,0.52,448.28,10.0,44.82,0,4.0,0,0,0.0,0,0,0,False,2021
315,001,1,2,2021-12-10,17:21:49,17022,17068,0,0,106.6,4.4,0,111,0,0,0,0,0,0,72475.21,72581.81,0,21.0,0,100.94,10.0,10.06,0,4.0,0,0,0.0,0,0,0,False,2021
316,001,1,2,2021-12-11,17:23:30,17069,17122,0,0,222.1,90.5,0,312.6,0,0,0,0,0,0,72581.81,72803.91,0.5,21.0,0.1,283.65,10.0,28.35,0,4.0,0,0,0.0,0,0,0,False,2021
317,001,1,2,2021-12-12,16:04:49,17123,17182,0,0,351.2,144.2,0,495.4,0,0,0,0,0,0,72803.91,73155.11,2.48,21.0,0.52,447.65,10.0,44.75,0,4.0,0,0,0.0,0,0,0,False,2021
318,001,1,2,2021-12-13,15:05:13,17183,17207,0,0,61.1,10,0,71.1,0,0,0,0,0,0,73155.11,73216.21,0,21.0,0,64.65,10.0,6.45,0,4.0,0,0,0.0,0,0,0,False,2021
319,001,1,2,2021-12-14,15:32:33,17208,17253,0,0,112.3,44.5,0,156.8,0,0,0,0,0,0,73216.21,73328.51,0,21.0,0,142.52,10.0,14.28,0,4.0,0,0,0.0,0,0,0,False,2021
320,001,1,2,2021-12-15,15:18:08,17254,17270,0,0,73.7,14.6,0,88.3,0,0,0,0,0,0,73328.51,73402.21,0,21.0,0,80.26,10.0,8.04,0,4.0,0,0,0.0,0,0,0,False,2021
321,001,1,2,2021-12-17,11:44:24,17271,17273,0,0,4.5,0,0,4.5,0,0,0,0,0,0,73402.21,73406.71,0,21.0,0,4.08,10.0,0.42,0,4.0,0,0,0.0,0,0,0,False,2021
322,001,1,2,2021-12-17,17:21:23,17274,17301,0,0,65.6,27,0,92.6,0,0,0,0,0,0,73406.71,73472.31,0,21.0,0,84.17,10.0,8.43,0,4.0,0,0,0.0,0,0,0,False,2021
323,001,1,2,2021-12-18,17:59:52,17302,17352,0,0,307.6,21,0,328.6,0,0,0,0,0,0,73472.31,73779.91,0,21.0,0,298.77,10.0,29.83,0,4.0,0,0,0.0,0,0,0,False,2021
324,001,1,2,2021-12-19,18:15:45,17353,17419,0,0,430.1,75,0,505.1,0,0,0,0,0,0,73779.91,74210.01,0.99,21.0,0.21,458.09,10.0,45.81,0,4.0,0,0,0.0,0,0,0,False,2021
325,001,1,2,2021-12-20,15:24:52,17420,17445,0,0,66.9,7,0,73.9,0,0,0,0,0,0,74210.01,74276.91,0,21.0,0,67.2,10.0,6.7,0,4.0,0,0,0.0,0,0,0,False,2021
326,001,1,2,2021-12-21,16:27:22,17446,17481,0,0,95.4,53,0,148.4,0,0,0,0,0,0,74276.91,74372.31,0,21.0,0,134.91,10.0,13.49,0,4.0,0,0,0.0,0,0,0,False,2021
327,001,1,2,2021-12-22,15:17:51,17482,17500,0,0,43.3,22.5,0,65.8,0,0,0,0,0,0,74372.31,74415.61,1.82,21.0,0.38,57.82,10.0,5.78,0,4.0,0,0,0.0,0,0,0,False,2021
328,001,1,2,2021-12-23,15:43:35,17501,17541,0,0,67,44.5,0,111.5,0,0,0,0,0,0,74415.61,74482.61,0,21.0,0,101.36,10.0,10.14,0,4.0,0,0,0.0,0,0,0,False,2021
329,001,1,2,2021-12-24,16:12:48,17542,17604,0,0,483.1,95.2,0,578.3,0,0,0,0,0,0,74482.61,74965.71,0,21.0,0,525.75,10.0,52.55,0,4.0,0,0,0.0,0,0,0,False,2021
330,001,1,2,2021-12-26,15:01:54,17605,17658,0,0,428,35.5,0,463.5,0,0,0,0,0,0,74965.71,75393.71,0,21.0,0,421.36,10.0,42.14,0,4.0,0,0,0.0,0,0,0,False,2021
331,001,1,2,2021-12-27,15:35:36,17659,17671,0,0,53.6,7,0,60.6,0,0,0,0,0,0,75393.71,75447.31,0.83,21.0,0.17,54.17,10.0,5.43,0,4.0,0,0,0.0,0,0,0,False,2021
332,001,1,2,2021-12-28,15:40:07,17672,17715,0,0,56.8,70.5,0,127.3,0,0,0,0,0,0,75447.31,75504.11,0,21.0,0,115.72,10.0,11.58,0,4.0,0,0,0.0,0,0,0,False,2021
333,001,1,2,2021-12-29,16:43:50,17716,17750,0,0,56.9,68.4,0,125.3,0,0,0,0,0,0,75504.11,75561.01,1.24,21.0,0.26,112.52,10.0,11.28,0,4.0,0,0,0.0,0,0,0,False,2021
334,001,1,2,2021-12-30,17:18:47,17751,17770,0,0,78.7,41,0,119.7,0,0,0,0,0,0,75561.01,75639.71,0,21.0,0,108.81,10.0,10.89,0,4.0,0,0,0.0,0,0,0,False,2021
335,001,1,2,2021-12-31,16:49:13,17771,17825,0,0,92.82,176.4,0,269.22,0,0,0,0,0,0,75639.71,75732.53,0.1,21.0,0.02,244.61,10.0,24.49,0,4.0,0,0,0.0,0,0,0,False,2021
336,001,1,2,2022-01-02,16:47:41,17826,17871,0,0,306.1,63,0,369.1,0,0,0,0,0,0,75732.53,76038.63,1.24,21.0,0.26,334.19,10.0,33.41,0,4.0,0,0,0.0,0,0,0,False,2021
337,001,1,2,2022-01-03,19:01:20,17872,17918,0,0,75.1,29.2,0,104.3,0,0,0,0,0,0,76038.63,76113.73,0,21.0,0,94.82,10.0,9.48,0,4.0,0,0,0.0,0,0,0,False,2021
